(h)ari-	harusp		haruspex
(h)ib-	hybri		hybrida
-a	s		canities, Carmentis, choraules, Pelias, planities, sophistes, Atrides
-a	e		Circe, cunae, Dione, elate, Ephyre, Erigone, facetiae, gnomonice, Grauiscae, Hecate, Hermione, heroine, Iugulae, Messene, Omphale, oporothece, oxymyrsine, Panope, Penelope, Phoenice, Pirene, Priene, Salonae, Scythice, Semele, Sinope, Taygete, Temese, Antemnae, Aphidnae, Ariane, Arsinoe
-a	n		Dindymon
-a	a		Patara
-aa	ae		Pasiphae
-acium	aceus		mustaceus
-aclum	culum		gubernaculum
-ae	ia		Cutilia
-ae	sa		Pagasa
-aea	hea		Amalthea
-aeum	geum		hypogeum
-aicus	aecus		Callaecus
-ans	mas		adamas
-apsis	opsis		paropsis
-ar(i)arius	pecularius		specularius
-aria	rius		brattiarius
-arpo	erpo		praecerpo
-as	ca		Proca
-as	pa		Agrippa
-asco	esco		teneresco
-ascor	pasco		depasco
-asis	psis		paropsis
-asius	aseus		Halicarnaseus
-assius	naseus		Halicarnaseus
-assius	nasius		Parnasius
-assus	nasus		Halicarnasus
-beia	baia		ambubaia
-ber	ris		insalubris
-beus	aeus		scarabaeus
-bris	eber		celeber
-byblos	biblos		monobiblos
-cha	uca		carruca
-chralis	lcralis		sepulcralis
-chretum	lcretum		sepulcretum
-chrum	lcrum		sepulcrum
-chuma	achma		drachma
-cium	acia		armoracia
-cius	ceus		hordeaceus
-cius	ctus		aulicoctus
-cla	ula		securicula
-clum	ulum		spectaculum, tomaculum, umbraculum
-cor	sco		pasco
-cre	rum		inuolucrum
-ctho- -cto-	ntichthones		antichthones
-cto	tor		amplector
-culus	culum		perpendiculum
-cunque	cumque		quacumque, qualiscumque, quandocumque, quicumque, quotienscumque, quantuscumque
-cuo	ueo		ablaqueo
-cus	uus		obliquus, pedisequus
-cus	ius		Anactorius
-cō	uo		discoquo
-datios	dateus		Mithridateus
-datius	dateus		Mithridateus
-decumani	decimani		quartadecimani
-decumanus	decimanus		quintadecimanus
-dianus	edanus		subaedanus
-dibilis	sibilis		comprehensibilis
-dinarius	denarius		cuppedenarius
-drea	drya		melandrya
-dros	nder		Menander
-drus	nder		Maeander, Anaximander
-e	l		capital
-e	i		procliui
-ea	ia		fascia, Galatia, spongia, adoria
-eius	geus		Sigeus, Argeus
-ela	lla		obsequella
-elis	ilon		onochilon
-ellum	illum		scabillum
-ellus	illus		codicillus
-enius	inius		faecinius
-enses	esses		decatresses
-ensimus	gesimus		nonagesimus, quinquagesimus
-ensimus	tesimus		nongentesimus
-ensius	nesius		Proconnesius
-ensus	nesos		Proconnesos
-ensus	nesus		Peloponnesus
-enus	inus		Dyrrhachinus
-eo	io		deascio
-eola	iola		fasciola, maceriola
-eor	reo		demereo, emereo, promereo
-eor	ceo		excalceo
-eris	aris		phalaris
-erosus	orosus		facinorosus
-es	ex		ramex
-esco	isco		delitisco
-esis	nsis		Peloponnensis
-essus	besus		obesus
-estor	mesor		comesor
-eteus	iteus		Polycliteus
-eticus	iticus		purpuriticus
-etius	iteus		Polycliteus
-etus	itus		Polyclitus
-eum	ion		psyllion
-eus	eus		Daedaleus, Atalantaeus
-eus	ius		pellicius, Pittheius, precarius, Taenarius, ambrosius, Aristotelius, aerius, aetherius
-eus	les		Achilles
-eē	ea		Leucothea
-eō	do		frendo, instrido
-eō	or		polliceor
zzz
-fascine	fiscini		praefiscini
-forus	horus	+1	pastophorus
-frango	fringo		diffringo
-giae	egae	--1	Aegae
-glesco	glisco		reglisco
-gni- -gine-	.	abiegnus		abiegnus
-go	eo	+1	detergeo
-guo	ngo	-2	tingo
-gō	eo	-3	extergeo
-i	s	-2	Tingis
-ia	ea		Chaeronea, Dicaearchea, tinea, Anticlea, collactea
-ia	ia		Paroreia
-ia	ra	-3	uniuira
-iae	eae		sculponeae
-iatus	eatus		excalceatus
-ici	qui	+1	antiqui
-ictor	nctor	+1	pollinctor
-icula	ecula		trabecula
-ideō	edeo		supersedeo
-ienses	nenses		Tarracinenses
-iensis	eensis		Heracleensis
-iensis	pensis	--1	Philippensis
-iensis	nensis	--1	Mediolanensis
-ies	ens	+1	aliquotiens, octingentiens, quindeciens, quingentiens, quinquagiens
-ietum	netum	+1	castanetum
-ilatim	llatim	+1	frustillatim
-illus	ellus		porcellus
-iniscō	niscor	+1	comminiscor
-iniō	lino	--1	circumlino, oblino
-innum	inium	--1	conticinium
-inpono	impono		superimpono
-iolus	eolus		phaseolus, argenteolus
-ion	ium		smyrnium, Aegium, cycnium, daemonium, anthyllium, apodyterium
-ion	eum		cichoreum
-ior	rio	--1	comperio, nutrio
-ior	cio	--1	nancio
-ior	tio	--1	partio
-ior	nio	--1	somnio
-ios	eus		Spercheus
-is	er	0	acipenser
-is	ys		Capys, pelamys
-is	us		effrenus, hilarus, inanimus, limus, multiforus, multiiugus, opiparus, quadriiugus, semisomnus, Anapus, unanimus
-is	on		Sason
-is	is		tigris
-isco	esco		uetustesco
-iscō	esco		insenesco
-isso	rizo		gargarizo
-itius	icius		nutricius
-ium	eum		gynaeceum, centaureum, euphorbeum, adoreum
-ium	num		sterculinum
-ium	lum	--1	amphimallum
-ium	ion		batrachion, dracontion
-ius	ter	--1	affluenter
-ius	eus		Pythagoreus, triticeus, arboreus, Cauneus, corticeus, farraceus, pannuceus, uinaceus, Hermioneus
-ius	ris	--1	tolutaris
-ius	rus	--1	bucerus
-ius	mus	--1	hippopotamus
-iēs	ens	+1	pauciens, quadragiens, septiens
-iō	or	-3	blandior, demolior, molior, sortior, adorior
-iō	pi	-1	coepi
-iō	eo	-3	percieo
-iō	io	-2	sororio
-iōn	ius		Iasius, Icadius
-leos	laus		Philolaus
-litus	ithus	+1	monolithus
-llaca	ilaca	--1	porcilaca
-locus	oquus	+1	grandiloquus, magniloquus
-lubet	libet		quilibet, quilibet, qualibet
-meitus	amitus	--1	Catamitus
-moeroe	imurus	--1	Aegimurus
-n	i	0	alioqui
-n	o	0	Croto, Croto, croto, Laco, phago, Plato, Polemo, Rubico, Tarraco
-n	s	-3	delphinus
-naris	iaris	+1	tricliniaris
-ne	ni		praefiscini
-nensis	iensis	+1	Statoniensis
-nensus	onesus	--1	Cherronesus
-nessus	onesus	--1	Cherronesus
-neus	aeus		Ariadnaeus
-nio	neo		delineo
-ns	as		praegnas
-num	ium	+1	Tauromenium
-nus	eus	--1	populneus
-nus	tan	0	Titan
-o	r	-2	criminor, expergiscor, imitor, adueneror
-odium	onium		septizonium
-oe	pi	-1	Arimaspi
-ola	ula		cellula
-olentus	ulentus		pisculentus
-olus	ulus		cliuulus, inuoluulus
-on	um		cinnamum, Sigeum, archetypum, arum
-on	to	0	Aristo
-ona	ana		cottana
-ona	nia	+1	Populonia
-onēs	ryon	-2	Geryon
-ope	pia	-4	Cassiepia
-opea	epia		Cassiepia
-or	to	-1	oscito, bubulcito, delecto, hieto, molesto, quirito, ructo, adiuto
-or	ro	-1	belligero, commurmuro, elucubro, honoro, munero, murmuro, pigro, admurmuro, auguro
-or	lo	-1	bello, latibulo, pugillo
-or	co	-1	commanduco, fabrico, fatisco, frutico, glisco, labasco, manduco, mendico, nutrico, proco, sacrifico, albico
-or	io	-1	conglacio, luxurio, radio, spolio
-or	no	-1	digno, hiberno, rumino, uermino
-or	po	-1	expalpo, participo
-or	uo	-1	fluctuo
-or	go	-1	indago, aurigo
-or	or		intueor
-oris	ecor		indecor
-oro	ero		pignero
-os	us		choreus, Halicarnasus, Heracleus, amethystus, acephalus, Bithynus, cammarus, catalecticus, chrysocarpus, clymenus, cyanus, Cyprus, dactylus, hendecasyllabus, heroicus, horaeus, hyoscyamus, isodomus, miurus, Molossus, monaulus, monogrammus, Naxus, obolus, Oxus, paliurus, paralius, physicus, Polyphemus, sophisticus, trimetrus, Achelous, adoptiuus, Aeacus, Anacreontius, Aspendius, atauus, atomus, Atticus, autopyrus, iambus, Ionicus
-ossis	exos	.	exos
-ous	hus	--1	Panthus
-paro	pero		aequipero
-partito	pertito		quadripertito
-parābilis	perabilis		aequiperabilis
-pertum	partum		antepartum
-plector	mplecto	--1	circumplecto
-plusio	plosio		supplosio
-purigo	rpurgo	--1	perpurgo
-quinus	rcinus	+1	hircinus
-quod	quot		aliquot
-quomque	icumque	--1	quicumque
-quonque	scumque	--1	quotienscumque
-quos	quus		obliquus
-quus	rcus	--1	hircus
-sideo	sedeo		circumsedeo
-sillus	xillus		pauxillus
-sio	tio		intentio
-so	uo	+1	exdorsuo
-spargo	spergo		circumspergo
-tae	tes		Aegates
-taria	teria		Pandateria
-taria	iaria	+1	ratiaria
-tarius	iarius	+1	ratiarius
-tensimus	ntesimus	--1	quadringentesimus
-ter	ter		sequester
-tia	tea		Necyomantea
-tor	rto	--1	praeuerto
-truo	ryon	--1	Amphitryon
-uclus	culus	+1	pediculus
-uculus	iculus		pediculus, anniculus
-uersum	uersus		quoquouersus
-ulter	liter	+1	difficiliter
-um	on		chalcanthon
-um	us		quoqueuersus, retrouersus
-um	te	-1	Tergeste
-um	ta	-1	armamenta
-umus	imus		septimus
-uorsum	uersus		quoquouersus
-us	um		costum, deorsum, dextrorsum, Misenum, aeuum
-us	lu	-1	gelu
-us	is		bisulcis, cannabis, elumbis, eneruis, exanimis, glanis, inermis, infrenis, interpolis, procliuis, sublimis, torris, forctis
-us	ur		camur
-us	os		cissanthemos, Otos, acrolithos, Arctos, Atheos
-us	nu	-1	genu
-us	us		Numicius, Oedipus, pinus
-us	uo		pauo
-uza	ssa	+1	obrussa
-yr	ur		Astur
-ys	us		Phorcus
-ā	a	-2	Argia
-āna	ena		Athena
-ātis	enas	-2	Capenas
-ē	a		Clytia, Dodona, Eriphyla, Europa, exagoga, geometrica, grammatica, Helena, Hersilia, Hesiona, Hippolyta, Ida, Iliona, Laconica, Leda, Leucata, Libya, mathematica, Melita, musica, parabola, Pella, phoca, Phthia, pinacotheca, poetica, Polyxena, Prochyta, Samothraca, Sparta, stacta, stela, symbola, Urania, Aeaea, Aetna, amygdala, Ariadna, arithmetica, Atalanta, Hippodamia, pyrricha, schola, Hypermestra
-ēa	ia		Seleucia, Antiochia
-ēbēs	lebs	+1	plebs
-ēn	io		Anio
-ēos	eus		Alpheus
-ēs	ae		druidae
-ēs	ia	-1	duritia, maceria, materia, militia, mollitia, munditia, notitia, pigritia, segnitia, spurcitia, tristitia
-ēs	ni	0	Edoni
-ēs	la	-1	hydraula
-ēs	ta	-1	Nabata
-ēs	as	-1	Pantagias
-ēs	ci	-1	Triboci
-ēs	is		Aeolis
-ēs	es		Apelles
-ēs	ea		Tegea
-ēs	us		Uologesus
-ēum	ium		glaucium
-ēus	eus	+1	Cydonaeus
-ēus	ius		Antiochius
-īa	ea		Achillea
-īn	is		Salamis
-īos	eus		Peneus
-īum	eum		alcyoneum, Amaltheum
-īus	eus		Carneadeus, Democriteus, Diomedeus, Homereus, Lyrceus, spondeus
-īī	ei	-1	Aristarchei
-ō	r	-2	cohortor, conuiuor, cunctor, depeculor, depopulor, euagor, exhortor, frustror, imaginor, insector, insidior, luctor, ludificor, minitor, miseror, moderor, morigeror, moror, mutuor, opitulor, osculor, peruagor, populor, praestolor, proelior, recordor, refragor, reluctor, remuneror, sciscitor, sermonor, suffragor, suspicor, tumultuor, uelitor, ueneror, uociferor, urinor, auspicor, auxilior, sauior, percontor
-ō	s	-2	Dercetis, silus
-ō	o		suboleo
-ōn	os		Androgeos
-ūs	iu	-1	diu
Acch-	Ache	--1	Acheruns, Acherunticus, Acherusius
Adr-	Had	--1	Hadria, Hadrianus, Hadriaticus
Aefl-	Aefu	+1	Aefulanus
Agr-	Acr		Acragantinus, Acragas
Agragant-	Agrigent		Agrigentini
Aim-	Aem		Aemilianus, Aemilius
Amunc-	Amync		Amynclanus
Amycl-	Amync	+1	Amynclae
App-	Ape	--1	Apenninicola, Apenninigena, Apenninus, Apenninus
App-	Apu	--1	Apulia, Apulus
Ario-	Areo		Areopagites
Athl-	Atla	--1	Atlanticus
Att-	Acc		Accius
Auel-	Abel		Abellanus
Bale-	Bali		Baliaricus, Baliaris
Bebr-	Bedr		Bedriacus
Beron-	Beren		Berenice
Betr-	Bedr		Bedriacensis, Bedriacum
Bub-	Byb		Byblos
Caele-	Caeli		Caelimontanus
Caer-	Cere	--1	Cerealicius, Cerealis
Calid-	Calyd		Calydonius
Camal-	Camul		Camulodunum
Caphar-	Capher		Caphereus, Caphereus
Capra-	Capro		Caprotina
Cass-	Casi	--1	Casinas
Ceri-	Cere		Cerealis
Ceu-	Ceb		Cebenna
Chalc-	Calch	+1	Calchedonensis
Cibu-	Ciby		Cibyrates
Clu-	Clo		Cloacina
Cocul-	Cocle	--1	Cocles
Compet-	Compit		Compitalis
Conl-	Coll		Collatia
Conp-	Comp		Compitalia, Compitalicius, Compitalis
Conseu-	Consiu		Consiuius
Culm-	Colm		Colminius
Cup-	Cyp		Cyprigenia
Curr-	Curi	--1	Curitis
Cygn-	Cycn		Cycneis
Cyp-	Cip		Ciprius
Delm-	Dalm		Dalmatia, Dalmaticus
Diuit-	Diuic		Diuiciacus
Duel-	Duil		Duillius
Duell-	Bello	--1	Bellona
Durra-	Dyrrh		Dyrrhachinus, Dyrrhachium
Ericth-	Ericht	+1	Erichthonius, Erichthonius
Euhad-	Euadn	--1	Euadne
Fac-	Fag		Fagutalis
Fac-	Pha	+1	Phacelinus
Far-	Pha	+1	Phariacus
Ferent-	Frenta	--1	Frentani
Ficol-	Ficul		Ficulensis
Fil-	Phi	+1	Philippus
Fin-	Phi	+1	Phineius
For-	Fur		Furrina
Furn-	Forn		Fornacalia
Gall-	Call		Callaecia, Callaecus
Genu-	Ceno		Cenomani
Germ-	Cerm		Cermalensis, Cermalus
Get-	Gae		Gaetulus
Gn-	Cn		Cnidos
Haed-	Aedu	--1	Aedui
Hale-	Hala		Halaesus
Hil(l)ur-	Illyricu	--1	Illyricus
Hil-	Ill	--1	Illyricum
Hord-	Ford		Fordicidia
Iapu-	Iapy		Iapydes, Iapydia
Iazu-	Iazy		Iazyges
Idy-	Idu		Idumaeus, Idume
Ipp-	Hip	+1	Hippolytus
Irp-	Hir	+1	Hirpinus
Ityr-	Itur		Ituraei, Ituraeus
Kar-	Car		Carthaginiensis, Carthago
Lacet-	Laeet		Laeetania, Laeetanus
Lalet-	Laeet		Laeetania, Laeetanus
Lat-	Let		Letois, Letoius, Letous
Lau-	Lab	--1	Labicanus
Lau-	Lao		Laodicensis, Laodicenus, Laomedon, Laomedonteus
Leuc-	Luce	--1	Lucetius
Lub-	Lib		Libentina
Luc-	Loc		Locusta
Lugd-	Lugu	+1	Lugudunum
Lyc-	Luc		Lucomedius
Marsu-	Marsy		Marsyas
Matt-	Mati	--1	Matius
Menenn-	Meneni	--1	Menenius
Ment-	Mint		Minturnae, Minturnensis
Mityl-	Mytil		Mytilenaeus, Mytilenensis
Mosall-	Mosell		Mosellicus
Nabath-	Nabata	--1	Nabataeus
Odiss-	Odyss		Odyssea
Ouf-	Ufe	--1	Ufens, Ufentinus
Pal-	Pal		Palatinus, Palatium
Panorm-	Panhor	+1	Panhormitanus
Pel-	Pae	--1	Paeligni, Paelignus
Plot-	Plau	+1	Plautius
Popl-	Publ		Publicola
Populi-	Poplif	--1	Poplifugia
Ramn-	Rham	+1	Rhamnusius
Rham-	Ramn	--1	Ramnes
Rheg-	Regi	--1	Reginus, Regium
Rhi-	Rip	--1	Ripaeus
Rod-	Rau	+1	Raudusculana
Rod-	Rho	+1	Rhodiensis, Rhodius, Rhodus
Romul-	Romil		Romilius
Rud-	Rau		Raudusculana
Sam-	Sem		Semiramis
Sar-	Ser		Serapio, Serapis
Saur-	Sora	--1	Soracte
Sic-	Sug		Sugamber
Sig-	Sug		Sugamber
Sipunt-	Sipont		Sipontinus
Sisp-	Sosp		Sospita
Summ-	Subm		Submemmianus
Syc-	Sug		Sugamber
Syg-	Sug		Sugamber
Tam-	Tom		Tomyris
Ter-	Tir		Tiresias
Thal-	Tala	--1	Talassius
Tham-	Tomy	--1	Tomyris
Theo-	Thei	+1	Theiodamas
Thio-	Thei	+1	Theiodamas
Threc-	Thrae	+1	Thraecidicus
Toloss-	Tolosa	--1	Tolosanus
Treuir-	Treuer		Treuericus
Trogl-	Trogo	--1	Trogodytae, Trogodyticus, Trogodytis
Virdu-	Uirid	+1	Uiridomarus
Vlis-	Olis		Olisipo
Xers-	Xerx		Xerxes
abb-	adb		adbibo
abf-	afl		afluo
abs-	aps		apsinthites, apsinthium, apsinthius
accers-	arcess		arcessitor, arcessitus
acu-	aqu		aquarius
acula aquu-	aquola	.	aquola
ad(g)n-	agnosc	--1	agnosco
ad-	ac		accedo
adc-	acc		accommodate, accumulate, accurate, acceleratio, accelero, accessio, accessus, acclamatio, acclamo, acclaro, acclinis, acclino, accliuis, accliuitas, accognosco, accola, accolo, accommodatio, accommodatus, accommodo, accommodus, accredo, accresco, accretio, accretus, accubitio, accubitus, accubo, accudo, accumbo, accumulatio, accumulator, accumulo, accuratio, accuratus, accuro, accurro, accursus
adf-	aff		affabiliter, affabre, affirmate, affluenter, affaber, affabilis, affabilitas, affamen, affatus, affectatio, affectator, affectio, affecto, affectus, affectus, affero, afficio, afficticius, affigo, affiguro, affingo, affinis, affinis, affinitas, affirmatio, affirmator, affirmo, affixa, afflatus, afflecto, affleo, afflexus, afflictatio, afflicto, afflictor, afflictrix, afflictus, afflictus, affligo, afflo, affluens, affluentia, affluo, affodio, affor, afformido, affrango, affremo, affrico, affrictus, affrio, affulgeo, affundo
adg-	agg		aggemo, aggero, aggestus, agglomero, agglutino, aggrauesco, aggrauo, aggredior, aggrego, aggressio, aggressor, aggressura, aggressus, agguberno
adgn-	agna	--1	agnata, agnatio, agnatum, agnatus
adgn-	agni	--1	agnitus
adgn-	agno	--1	agnomen, agnomentum
adl-	all		allabor, allaboro, allacrimo, allambo, allapsus, allatro, allaudabilis, allaudo, allauo, allectatio, allecto, allector, allegatio, allegatus, allego, allego, alleuamentum, alleuatio, alleuo, alleuo, allicefacio, allicio, allido, alligatio, alligator, alligatura, alligo, allino, alliuesco, allocutio, alloquium, alloquor, allubentia, alluceo, alluctor, alludio, alludo, alluo, alluuies, alluuio
adol-	adul		adulescens, adulescentia
adp-	app		apparate, appetenter, apposite, apprime, approbe, apparatio, apparator, apparatorium, apparatus, apparatus, apparens, appareo, appario, apparitio, apparo, appello, appello, appendo, appetens, appetentia, appetibilis, appetisso, appetitio, appetitus, appeto, appiciscor, appingo, applausus, applicatio, applicatus, applicitus, applico, apploro, applumbator, applumbo, appono, apporrectus, apportatio, apporto, appositus, appotus, apprecor, apprehendo, apprenso, apprimo, apprimus, approbatio, approbator, approbo, approbus, appromissor, appromitto, approno, appropero, appropinquatio, appropinquo, appugno, appulsus
adp- applodo	app		applaudo
adq-	acq		acquiesco, acquiro, acquisitio, acquisitrix, acquisitus
adr-	arr		arrepo, arrideo, arrigo, arripio, arrisio, arrisor, arrodo, arrogans, arroganter, arrogantia, arrogatio, arrogator, arrogo, arrosor, arruo
ads-	ass		assecue, assentatorie, asseuerate, assiduo, assimiliter, assimulanter, assudesco, assultim, assectatio, assectator, assector, assensio, assensor, assensus, assentatio, assentatiuncula, assentator, assentio, assentior, assentor, assequor, assero, assero, assertio, assertor, asseruio, asseruo, assessio, assessor, assessura, assestrix, asseueranter, asseueratio, asseuero, assibilo, assiccesco, assicco, assideo, assido, assidue, assiduitas, assiduus, assignatio, assignator, assignifico, assigno, assilio, assimilis, assimulatio, assipio, assisto, assitus, associo, assoleo, assono, assubrigo, assuefacio, assuesco, assuetudo, assuetus, assugo, assulto, assultus, assumo, assumptio, assumptiuus, assuo, assurgo, assuscipio, assuspiro
ads-	asc	--1	ascensus, ascio, ascisco, ascribo, ascripticius, ascriptio, ascriptiuus, ascriptor
ads-	asp	--1	aspectus, aspicio, aspiramen, aspiratio, aspuo
ads-	ast	--1	astator, asterno, astipulatio, astipulator, astipulatus, astipulor, astituo, asto, astrepo, astricte, astrictio, astrictorius, astrictus, astringo, astruo, astupeo
ads- assecla	ass	.	assecula
adsc-	asce	--1	ascendo
adt-	att		attemperate, atterraneus, attactus, attempero, attendo, attente, attentus, attenuatio, attenuo, attero, attestatio, attestatus, attestor, attexo, attibernalis, attineo, attingo, attollo, attondeo, attonitus, attono, attorqueo, attractus, attraho, attrectatio, attremo, attrepido, attribuo, attributio, attritus, attritus, attumulo, attuor
adt- attento	att	.	attempto
adt- attracto	att	.	attrecto
aduerto -uorto	angu		animaduerto
adul-	adol		adolesco
aduor-	aduer		aduerto
aduors-	aduers		aduersabilis, aduersarius, aduersarius, aduersatrix, aduersitor, aduerso, aduersor, aduersum
aestu-	aesti		aestimatio
agn-	acn		acnua
ahen-	aene	--1	aeneum, aeneus
all-	ali	--1	alium
alum-	alim		alimentarius, alimentum
amf-	anf		anfractus
amm-	adm		adminiculum, administer, administro, admiror, admoneo, admoueo
anet-	anat		anaticula, anatinus
angl-	angu	+1	angulatus
angol-	angul		angularius
ann-	adn		adnato, adnitor, adno, adnumero, adnuntio, adnuo
anti-	ante		antegerio, antecessus, antesto
anticus -cuus	qui	.	antiquus
antil-	antel		antelucanus
apoca-	apoch	+1	apochatus
aps-	abs		absque, absurde, absum, abscedo, abscido, abscondo, absens, absentia, absoluo, absonus, absorbeo, absterreo, abstineo, absto, abstraho, abstrudo, abstrusus, absumedo
arct-	arto	--1	arto
arcu-	arqu		arquatus
argi-	arge		argemonia
arqu-	arcu	--1	arcuatura, arcuatus
arqui-	arcip	--1	arcipotens
arqui-	arcit	--1	arcitenens
arre-	haru		haruspex
arre-	arrh	+1	arrhenicum
aru-	adu		adueho
aspargo ads-	aspergo	.	aspergo, aspergo
assimilo ads-	assimulo	.	assimulo
astrideo ads-	astrido	.	astrido
auct-	autu	--1	autumnitas
aure-	auri		aurificina
baio-	baiu		baiulus
balin-	balne	--1	balnearius, balneator, balneum
benif-	benef		beneficium, beneficus
beniu-	beneu		beneuole, beneuolens, beneuolentia, beneuolus
berul-	beryl		beryllus
bess-	besa	--1	besalis
blatt-	blate	--1	blatero
bybl-	bibl		bibliopola, bibliotheca
caet-	cete	--1	ceterus
cal-	gal		galbeus
cal-	kal		kalendae, kalendarium
calci-	calce		calceamentum, calcearium, calcearius, calceator, calceatus, calceo
cald-	cali	+1	calidarius
calic-	calyc		calyculus
calien-	calian		caliandrum
capri-	capre		capreolus
care-	cary		caryota
cari-	cary		caryota
carnu-	carni		carnificina, carnificius
cataph-	catafr	--1	catafractarius, catafractus, catafractes
cem-	cae	+1	caementicius, caementum
cer-	ger		gerro
cerc-	circ		circius
chir-	cher		cheragra, cheragricus
chort-	cohor	+1	cohortalis
circun-	circum		circumdo
clam-	chla	+1	chlamys
clathr-	clatra	--1	clatratus
clod-	clau	+1	claudigo
clos-	clau	+1	claustellum, claustrarius, claustrum
clup-	clip		clipeatus, clipeo
clus-	clys		clyster
cod-	cau	+1	caudicarius
coherc-	coerce	--1	coerceo
coherc-	coerci	--1	coercitio
col-	coa	--1	coalesco
coli-	caul	+1	cauliculus
collu-	colly		collybus
collub-	collib		collibuit
coloe-	colyp	--1	colyphium
comaud-	coaudi	--1	coaudio
comm-	comi	--1	comissatio
compet-	compit		compitum
con-	com		combenno
conang-	coangu	--1	coangusto
conb-	comb		combibo, combibo, comburo, combustum
concalf-	concale	+1	concalefacio
concamar-	concamer		concameratio
coninq-	coinqu		coinquo
conl-	coll		collabasco, collabefacto, collabefio, collabello, collabor, collacrimatio, collacrimo, collactaneus, collacteus, collaticius, collatio, collatiuus, collator, collatro, collaudatio, collaudo, collectio, collega, collegium, colleuo, colliberta, collibertus, collibro, collibuit, colliciae, colliciaris, collido, colligatio, colligo, collimo, collino, colliquefacio, colliquesco, collisio, collisus, collisus, collocatio, colloco, collocupleto, collocutio, colloquium, colloquor, colluceo, colluco, colluctatio, colluctor, colludo, collumino, colluo, collurchinatio, collusim, collusio, collusor, collusorie, collustrium, collustro, collutio, collutulento, colluuiaris, colluuies, colluuio, collacero, collinio
conm-	comm		commemoramentum, commemoratio, commemoro, commercor, commereo, commetior, commitigo, committo, communis, communitus
conn-	cone	--1	conecto, conexus
conn-	coni	--1	conitor, coniueo
conp-	comp		compactus, compaganus, compages, compago, compar, comparabilis, comparate, comparatio, comparatio, comparatiue, comparatiuus, comparator, comparatus, compareo, comparo, comparo, compartior, compasco, compascuus, compastor, compatriota, compatronus, compauesco, compauio, compedio, compeditus, compellatio, compello, compello, compendiaria, compendiarium, compendiarius, compendiosus, compendium, compenso, comperco, comperendinatio, comperendinatus, comperendino, comperendinus, compernis, compertusio, compes, compesco, competens, competenter, competentia, competitor, competitrix, competo, compilatio, compilo, compilo, compingo, compitensis, complaceo, complaco, complanator, complano, complector, complementum, compleo, completus, complexio, complexiuus, complexus, complico, complodo, comploratio, comploratus, comploro, compluit, complures, compluriens, complurimi, compluscule, complusculi, compluuiatus, compluuium, compono, comportatio, comporto, compos, composite, compositicius, compositio, composito, compositor, compositum, compositus, compotatio, compotens, compotio, compoto, compotor, compotrix, compraecido, compraes, compransor, comprecatio, comprecor, comprehendo, comprehensibilis, comprehensio, comprehenso, compresse, compressio, compressor, compressus, compressus, comprimens, comprimo, comprobatio, comprobator, comprobo, compromissarius, compromissum, compromitto, compugno, compulsio, compulso, compungo, computabilis, computatio, computator, computo, computresco
conr-	corr		corrado, correctio, corrector, correctus, corregio, correpo, correpte, correptio, correptus, correus, corrideo, corrigo, corripio, corriuatio, corriuo, corroboro, corrodo, corrogo, corrotundo, corrugo, corrumpo, corruo, corrupte, corruptela, corruptio, corruptor, corruptrix, corruspor
contut-	contui	+1	contuitus
conuor-	conuer		conuerto
cop-	cau	+1	caupona
cop-	coo	+1	cooperculum, cooperimentum, cooperio, cooptatio, coopto
corolit-	coralli	--1	coralliticus
corollit-	corallit		coralliticus
cot-	cot		cottidiano, cottidie, cottidio
coti-	cott	+1	cottidianus
crab-	grab		grabatus
crass-	grass		grassator
cum-	cym		cymatium
cupe-	cupp	+1	cuppedia, cuppedo
cupi-	cupp	+1	cuppedia
defrud-	defrau	+1	defraudo
deiur-	deier		deiero
delachr-	delacri	--1	delacrimatorius
deliq-	delic		delicuus
dem-	dam		damiurgus
dem-	dim		dimetior, dimetor
dendrof-	dendrop	--1	dendrophorus
der-	dir		directe, directio, directo, directura, directus, dirigo
des-	dis		dissignator
deuor-	deuer		deuersor, deuersorius, deuerticulum, deuerto
dimm-	dimi	--1	diminuo
dirr-	diru	--1	dirumpo
disr-	diru		dirumpo
diu-	deu		deuerbium, deuersorium
dole-	doli		doliarium, doliarius
domi-	dome		domefactus
duell-	bella	--1	bellator
duell-	belli	--1	bellicus
dysint-	dysent		dysenteria, dysenterici
ebur-	ebor		eborarius, eboratus
ecn-	enu	--1	enubo
ed-	he	--1	hedera, hederaceus
ed-	ae	+1	aedificiolum, aedilicius, aedilis
el-	he	+1	helops, heluella
ell-	hel	+1	helluor
emi-	hem	+1	hemitritaeus
enl-	ell		ellychnium
epistol-	epistul		epistularis
erad-	exra	--1	exradicitus
erung-	eryng		eryngion
esc-	aes	+1	aesculetum, aesculus
ex(s)erc-	exsarcio		exsarcio
ex(s)ol-	exulo	--1	exulo
exf-	eff		effluo, effodio, effrico, effugio
exint-	exent		exentero
exops-	exobs		exobsecro
exr-	era	--1	eradico
exr-	ero	--1	erogo
exs-	exi	--1	exilium
exs-	exo	--1	exolesco
exs-	exu	--1	exulatio, exulatus, exulo
fael-	fele	--1	feles
faet-	foet		foeteo, foetidus, foetor
famil-	famul		famulitas
farct-	fartu	--1	fartum, fartus
fas-	pha	--1	phaseolus
fec-	fae	+1	faecula, faeculentus
fen-	fae	+1	faenarius, faenebris, faeneratio, faenerator, faeneratorius, faeneratrix, faenero, faenicularius, faeniculum, faenilia, faenisex, faenisicia, faenisicium, faenum, faenus, faenusculum
feru-	ferr	+1	ferrumen, ferruminatio, ferrumino
fet-	foe	+1	foeteo, foetidus, foetor, foetulentus, foetutina
figil-	figli	+1	figlinae
figul-	figli		figlinae
fist-	fest		festuca, festucatio, festuco
fore-	fori		foricula
fremeb-	fremib		fremibundus
fryg-	phry	+1	phrygio
fundol-	fundul		fundulum
futil-	futti	--1	futtilis, futtilitas
gar-	car		caryophyllon
gene-	geni		genista
glaeb-	gleba	--1	gleba
glaeb-	glebo	--1	glebosus
glaeb-	glebu	--1	glebula
gles-	glae	+1	glaesum
gluc-	cluc	--1	clucidatus
glut-	glit		glittus
gn-	na	--1	nascor, nauo
gna-	nau	--1	nauiter
grauid-	graued		grauedinosus
grem-	crem		cremialis, cremium
gumm-	cumm		cummitio
hab-	abu	--1	abunde
hal-	ali	--1	alica, alicarius, alicarius, alicastrum
hal-	alu	--1	alucinatio, alucinor
halof-	halop	+1	halophanta
hap-	apa	--1	apalus
hei-	eiu	--1	eiulatus, eiulito
hel-	elu	--1	elucus
herc-	erci	--1	erciscor
hordi-	horde		hordeaceus, hordearius
hum-	ume	--1	umecto, umectus
hum-	umi	--1	umidus
iaent-	ienta	--1	ientaculum
iai-	iei		ieiunitas
iant-	ient		ientaculum, iento
ieient-	iento	--1	iento
ill-	ili	--1	ilico
inadf-	inaff		inaffectatus
inb-	imb		imbalnities, imbarbesco, imbecille, imbecillitas, imbecillus, imbellia, imbellis, imberbis, imbibo, imbito, imbubino
incomprens-	incomprehe	--2	incomprehensibilis
indep-	indip		indipiscor
infid-	infun		infundibulum
infum-	infim		infimatis
inioc-	iniuc		iniucundus
inm-	imm		immaculatus, immadesco, immanis, immanitas, immaniter, immansuetus, immature, immaturitas, immaturus, immedicabilis, immedicatus, immeditate, immeditatus, immeio, immemor, immemorabilis, immemoratus, immemoria, immensitas, immensum, immensum, immensus, immeo, immerens, immerenter, immergo, immerito, immeritus, immersabilis, immetatus, immetuens, immigro, imminuo, imminutio, imminutus, immisceo, immiserabilis, immisericorditer, immisericors, immissarium, immissio, immitis, immitto, immixtus, immobilis, immoderate, immoderatio, immoderatus, immodeste, immodestia, immodestus, immodice, immodicus, immodulatus, immolatio, immolator, immolitus, immolo, immorior, immoror, immortalis, immortalitas, immortaliter, immortalitus, immotus, immoueo, immugio, immulgeo, immunditia, immundus, immunio, immunitas, immunitus, immurmuro, immusulus, immutabilis, immutabilis, immutabilitas, immutabiliter, immutatio, immutatus, immutesco, immutilatus, immuto
inr-	irr		irrado, irrasus, irrationabilis, irreligatus, irreligiose, irreligiosus, irremeabilis, irremediabilis, irremunerabilis, irreparabilis, irrepertus, irrepo, irreposcibilis, irreprehensus, irrepto, irrequiebilis, irrequietus, irresectus, irresolubilis, irresolutus, irrestinctus, irretio, irretortus, irretusus, irreuerens, irreuerenter, irreuerentia, irreuocabilis, irreuocatus, irridenter, irrideo, irridicule, irridiculum, irridiculus, irrigatio, irrigiuus, irrigo, irriguus, irrisio, irrisor, irrisus, irritabilis, irritabilitas, irritamen, irritamentum, irritatio, irritator, irritatus, irrito, irritus, irroborasco, irroboro, irrogatio, irrogo, irroro, irrubesco, irructo, irrugo, irrumabiliter, irrumator, irrumo, irrumpo, irruo, irruptio, irruptus, irraucesco
insap-	insip		insipiens
insup-	insub		insubtilis, insubtiliter
int-	ind		indusiatus, indusium
intellig-	intelleg		intellegentia
interkal-	intercal		intercalaris
inuol-	inuul		inuulnerabilis
ioc-	iec		iecusculum
ioc-	iuc		iucunditas, iucundus
ir-	hi	--1	hirundo
irq-	hir	--1	hirquitallus
isci-	isch	+1	ischiacus
kal-	cal		calumnia
kan-	can		canabae, candidatus, candidatus
kap-	cap		capitularium
kata-	cata		catafractarius
lagun-	lagon		lagonarius
linia-	linea		lineamentum
liter-	litte	+1	litterula
lub-	lib		libenter, libentia, libidinitas, libidinose, libidinosus, libido
luc-	loc		locusta
lunt-	lint		lintriculus
lynt-	lint		lintrarius
macch-	macha	--1	machaera
maii-	maie	--1	maiestus
malif-	malef		maleficus
maliu-	maleu		maleuolentia, maleuolus
mammi-	mamme		mammeatus
mancup-	mancip		mancipatio
mani-	manu		manubrium
manipl-	manipu	+1	manipularis, manipularis
manupl-	manipu	+1	manipularis, manipularius
matru-	matri		matrimonium
mel-	mel		mellina
meli-	medi		medipontus
men-	mae	+1	maenianum
metic-	metuc		metuculosus
mil-	smi	--1	smilax
mill-	mili	--1	miliarium, miliarius, miliens
moet-	muti	--1	mutinus
molt-	mult		multaticus
most-	mons	+1	monstro
mucc-	muco	--1	mucosus
multun-	multin		multinummus
murr-	muri	--1	muricidus
murt-	myrt		myrtatum, myrteolus, myrtetum
naeuol-	naeuul		naeuulus
nao-	nau		naufylax
nauph-	naufy	--1	naufylax
nec-	neg		neglectus, neglectus, neglegens, neglegenter, neglegentia, neglego
nouemd-	nouend		nouendialis
nubt-	nupt		nuptialis
nung-	nong		nongentesimus
obc-	occ		occaeco, occallesco, occensus, occento, occludo, occumbo, occurro, occurso, occuro
obed-	oboe		oboedientia
obg-	ogg		oggannio
obp-	opp		oppeto, oppexus, oppono, opprimo, opprobrium, opprobro, oppugnatio, oppugnator, oppugno
obscaen-	obsceni	--1	obscenitas
obscaen-	obscenu	--1	obscenus
obst-	obtr	--1	obtrudo
obtract-	obtrect		obtrectatio
occup-	occip		occipio
octag-	octog		octogesimus
ole-	olf	--1	olfactus
omm-	obm		obmento, obmisceo, obmolior, obmoueo, obmutesco
oport-	oppor	--1	opportune, opportunitas, opportunus
opr-	obr		obrepo
ops-	obs		obscaeuo, obscenus, obscuro, obscurus, obsecratio, obsecro, obsecula, obsecundo, obsequens, obsequenter, obsequiosus, obsequium, obsequor, obsero, obseruatio, obseruo, obsessor, obsianus, obsideo, obsidio, obsidium, obsigno, obsisto, obsitus, obsonator, obsonatus, obsonium, obsono, obsorbeo, obstetricius, obstetrix, obstino, obsto, obstrepo, obstringo, obstruo, obstupidus, obsum, obstipesco
opst-	obtr	--1	obtrudo
opt-	obt		obtaedescit, obtego, obtempero, obtendo, obtentus, obtero, obtestor, obticeo, obticesco, obtineo, obtingo, obtorpesco, obtorqueo, obtrectatio, obtrectator, obtrudo, obtrunco, obtueor, obtundo, obturamentum, obturbo, obturo, obtutus
or-	ho	+1	horiola
or-	au	+1	auresco, auricula, auricularius, auriga
ord-	hor	+1	hordeaceus, hordeum
ost-	ust		ustilis
ostri-	ostre		ostrearium, ostreosus
paen-	penu	--1	penuria
paeon-	paeon		paeonicus
pal-	pha	+1	phalangarius
palmo-	palmi		palmipedalis, palmipes
panu-	pani		panicula
passe-	passi		passiolus
ped-	pae	+1	paedagogus, paedicator, paedico, paedico, paedor
peii-	peie	--1	peiero
pel-	pae	+1	paelex, paelicatus
pell-	pael		paelex
pell-	perl		perlectio, perlucidus
pen-	pae	+1	paenultimus
periur-	peiuri	--1	peiurium
perl-	pell		pellecebra, pellicio
phal-	fala	--1	falarica
philu-	phily		philyra
plebic-	plebec		plebecula
plen-	blen		blennus
plos-	plau	+1	plausor, plaustrarius
plost-	plaus	--1	plaustralis
plot-	plau	+1	plautus
plurum-	plurim		plurimum, plurimus
poen-	paen		paenitentia, paeniteo
poll-	paul	+1	paullulus, paululum
pomoer-	pomeri	--1	pomerium
popl-	publ		publicus
praec-	preci	--1	precia
praecent-	praecant		praecanto
pret-	prec		precia
primo-	primi		primipilaris
ptis-	tisa	--1	tisana
pulcr-	pulch	+1	pulchritudo
pux-	pyx		pyxidicula
quadran-	quadria	+1	quadriangulus
quadri-	quadru		quadrupedans, quadrupedus, quadrupes, quadruplator, quadruplex, quadruplicato
quadrig-	quadrin	+1	quadringenti
quadru-	quadri		quadripertitus, quadriuium, quadriuius
quat-	quad		quadriduum
quoi-	cuiu	--1	cuiusnam
quot-	cott	--1	cottidianus, cottidie
quoties-	quotien	--1	quotienscumque
rag-	rha	+1	rhagadia
rec-	ric		riciniatus
recc-	reci	--1	recido
recon-	recom		recompono
reconl-	recoll		recolligo
redd-	redu	--1	reduco, redux
reum-	rheu	+1	rheumaticus
rin-	rhi	+1	rhinoceros
rud-	rau	+1	raudusculum
rus-	rur	+1	rursus
russ-	rurs		rursus
sad-	sed		sedum
saecl-	saecu	+1	saecularis
saep-	sepi	--1	sepia
sama-	same		samera
samb-	sabu	--1	sabucus
sanguinu-	sanguino		sanguinolentus
sapph-	sappi	--1	sappirus
sarcof-	sarcop	+1	sarcophagus
sarr-	sari	--1	sario
sarr-	serr		serracum
satur-	satyr		satyricus
saur-	sore	--1	sorex
scamm-	scamo	--1	scamonia
scaturig-	scaturri	+1	scaturriginosus
sep-	sae	+1	saepes, saepicula, saepimen, saeptum
septemt-	septent		septentriones
set-	sae	+1	saetiger, saetosus
seu-	seb	--1	sebacium
sexd-	sede	--1	sedecim
sifon-	sipho	+1	siphonarius
sil-	sel		seliquastrum
siph-	sipa	--1	siparum
sipon-	sipho	+1	siphonarius
sirp-	scir	+1	scirpea, scirpiculus
sisp-	sosp		sospes
sit-	set		setanius
sob-	sub		suboles
soll-	soli	--1	solistimus
solli-	solif	--1	soliferreum
spaer-	sphae	+1	sphaerita
spintyrn-	spinturn		spinturnix
spon-	spho	+1	sphondylus, sphondylion
sponge-	spongi		spongiosus
sterci-	stercu		sterculinum
sterqui-	stercul	--1	sterculinum
stili-	still	+1	stillicidium
subadr-	subarr		subarroganter
subads-	subass		subassentior
subc-	succ		succenturio, succerno, succido, succingulum, succlamo, succresco, succubo, succumbo
subgill-	suggill		suggillatio
subii-	subic	--1	subices
succ-	subc		subcurator
succed-	succid		succidaneus
sugill-	suggil	--1	suggillatio
sugr-	sugg		suggrunda
summ-	subm		submano, submergo, subministro, submisse, submissim, submissus, submitto, submotus, submoueo, submurmuro, submussus, submuto
sup-	sub		subsiciuus
supp-	supe	--1	supellex
sups-	subs		subscus, subsilio
supt-	subt		subtilitas, subtiliter, subtraho
supter-	subter		subterduco, subterfugio
surp-	subr		subripio
surrip-	subrip		subripio
suss-	subs		subsilio, subsulto
synod-	synho	+1	synhodus
techn-	techi	--1	techina
ted-	tae	+1	taeda
tegm-	tegi	+1	tegimen, tegimentum
tegum-	tegim		tegimen, tegimentum
tent-	temp		tempto
tent-	tens		tensus
thal-	tala	--1	talassio
thens-	thesa	--1	thesaurarius
thur-	tura	--1	turarius
tini-	tine		tineosus
tral-	tran	+2	translaticius, translatio, translatiuus, translatus, transloquor, transluceo, translucidus
tram-	tran		transmarinus, transmeo, transmigro, transmitto
transd-	traduc	--2	traduco
transs-	transc	--1	transcribo, transcripticius, transcriptio
transs-	transe	--1	transero
transs-	transi	--1	transilio
transs-	transp	--1	transpectus, transpicio
transs-	transu	--1	transumptio
tras-	tran	+1	transenna, transpectus
trau-	tran	--1	transuectio, transueho, transuersarius, transuersus, transuerto
tribul-	tribol		tribolus
tric-	trec		trecenties
uae-	uec		uecordia, uecors
uaes-	uesa	--1	uesania, uesanus
uem-	ueh	+2	uehemens, uehementer
uenterc-	uentric	--1	uentriculus
uigila-	uigili	+1	uigiliarium
uill-	uili	--1	uilica, uilicatio, uilico, uilico, uilicus
uinul-	uinol		uinolentia, uinolentus
uitri-	uitre		uitrearius
uiui-	uiue		uiueradix
unae-	unet	--1	unetuicesimani
unet-	unae	+1	unaetuicesima
uniet-	unaet		unaetuicesima
unq-	umq		umquam
uolg-	uulg		uulgaris, uulgarius, uulgatus, uulgo, uulgus
uoln-	uuln		uulnerarius, uulneratio, uulnero, uulnus
uolp-	uulp		uulpes, uulpinus
uolt-	uult		uultur, uultus
uolu-	uulu		uulua, uuluula
uors-	uers		uersicapillus, uersipellis, uersutus
utrob-	utrub		utrubique
zmaragd-	smaragd		smaragdus
