adipson	-os
an1	ambi-).	x
au2	verb-forms.	x
bratus	-ā-	2	-3
caro1	carr-	3
certisco	-issō
chamaeleon	-os
compasco	(-pāuī),	x
confero	(conl-)	x
crebrinodus	-nōdōsus	-5
cuccuru	'Cock-a-doodle-doo!'.	x
cumulatus	-ior,	~
eopte	-pte.	x
gestio2	-īre,	x
Hellespontias	-ae	~
Hymen	Hȳm-
infero	(inl-)	x
ipsemet	-met.	x
mordeo	(mem-),	x
nosmet	-met.	x
psi	twenty-third	x
Rex2	144-143	x
rubellio	-ōnis	~
secundus1	1-4)	x
semet	-met.	x
seruula	-ola.	x
seruulus	-olus.	x
sortior	-īrī,	~
spondeo	(spep-)	x
suapte	-pte.	x
suopte	-pte.	x
syrus1	fourth-declension	x
tras	trans-.	x
tulat	tel-	x
ueteratus	-um	~
haliaetos	-aeetos	-5
percontor	-cuntor
terripauium	-puuium
unetuicesima	ūniet-	4
