baetis	baetis	baet,bet	bāet,bĕt
contraeo	contraeo	contrai	cōntrăĭ
exhorreo	exhorreō	exhorru	ēxhōrrŭ
interiaceo	interiaceō	interiacu	īntērjăcŭ
soter	sōtēr	sōtōr	Sōtōr
anteris	antēris	antēridi	āntēridi
synechitis	synechītis	synechītidi	synechītidi
adseruio	adseruiō	adseruīu	ādsērvīv
sandyx	sandyx	sandīc	sāndīc
circumsideo	circumsideo	circumsēd	cīrcūmsēd
compluit	compluit	complu,complūu	cōmplŭ,cōmplūv
condecet	condecet	condecu	cōndĕcŭ
oxyartes	oxyartēs	oxyart,oxart	Ōxўārt,Ōxārt
praeiens	praeiens	praeeūnt	prăeēunt
tiphys	tīphys	tīphyos	Tīphўos
coinfero	coinfero	cointul	cŏīntŭl
introdeo	introdeo	introdi	īntrodĭ
phylacies	phylaciēs	phylaciid	Phўlăcĭĭd
atthis2	atthis	atthy	Ātthў
gnossias	gnossias	gnossinos	Gnōssĭnos
philochares2	philocharēs	philocharētis	Phĭlŏchărētis (
aether2	aether	aetheris	Āetheris (er
ferbeo	ferbeo	ferbu	fērbŭ
subcubo	subcubo	subcubu	sūbcŭbŭ
bonus	bonus	meli	mĕlĭ
conuomo	conuomo	conuomu	cōnvŏmŭ
paruus	paruus	min	mĭn
soracte	sōracte	sōract,sauract	Sōrāct,Sāurāct
subdomo	subdomo	subdomu	sūbdŏmŭ
subterhabeo	subterhabeo	subterhabu	sūbtĕrhăbŭ
magnus	magnus	māj	māj
malus	malus	pēj	pēj