amplius	Comparative of amplus or its adverb
abalienatus	participle of abaliēnō
abdicatus	participle of abdicō1
abditus	participle of abdō
abiectus	participle of abiciō
abscisus	participle of abscīdō
absconditus	participle of abscondō
absens	participle of absum
abstrusus	participle of abstrūdō
abundans	participle of abundō
accensus1	participle of accenseō
acceptum	participle of accipiō
acceptus	participle of accipiō
accidens	participle of accidō1
accitus1	participle of acciō
accommodatus	participle of accommodō
accretus	participle of accrescō
accuratus	participle of accūrō
acquisitus	participle of acquīrō
actum	participle of agō
acutus	participle of acuō
adapertus	participle of adaperiō
addictus1	participle of addīcō
adductus	participle of addūcō
adiacens	participle of adiaceō
adiunctum	participle of adiungō
adiunctus	participle of adiungō
adminiculatus	participle of adminiculō
admonitum	participle of admoneō
adnotatus2	participle of adnotō
aduectus1	participle of aduehō
aduersus1	participle of aduertō
adulans	participle of adūlor
adulescens1	participle of adolescō1
adulteratus	participle of adulterō
adumbratus	participle of adumbrō
aduocata	participle of aduocō
aduocatus	participle of aduocō
adurens	participle of adūrō
adustum	neut. of adustus
adustus	participle of adūrō
aequum	neut. of aequus
aestimatus1	participle of aestimō
affectatus	participle of affectō
affectus2	participle of afficiō
affixa	participle of affīgō
afflexus	participle of afflectō
afflictus1	participle of afflīgō
affluens	participle of affluō
afluens	participle of āfluō
agens	participle of agō
agitatus1	participle of agitō
agnata	participle of agnascor
agnatum	participle of agnascor
agnatus1	participle of agnascor
agnatus2	participle of agnascor
aiens	participle of āiō
albens	participle of albeō
algens	participle of algeō
alienum	neut. of aliēnus1
alternatus	participle of alternō
altus	participle of alō
amans1	participle of amō
amata1	participle of amō
amatorium	neut. of amātōrius
amatus	participle of amō
ambiguum	neut. of ambiguus
ampulla	diminutive of amphora
ancilla	diminutive of  $ ancula ^  (see anculus)
angustum	neut. of angustus
animatus1	participle of animō
annus	< * $ at-nos ^ , cf. Gothic aþnam (dative pl.) 'year',  $ at-aþni ^  'year'; cf. also Umbrian acnu (=  $ annos ^ ),  $ sev-akne ^  (=  $ sollemnem ^ )
antecedens	present participle of antecēdō
apertus	participle of aperiō
apparatus1	participle of apparō
apparens	participle of appāreō
