! the following are the wrong models in collatinus
! not sure why the macrons are on there
circumdō	do
pessumdo	do
pessundo	do
satisdo	do
superdo	do
vēnumdō	do
vaenumdo	do
stō	do
nihil	inv
tuus	tuus
bos	homo
uallus2	manus
peneus2	lupus_g
cauus2	lupus_g
chius2	lupus_g
rusticulus2	virus_sg
himera3	vita_sg
larius2	lupus_voc
sestertius2	artios
dardanus2	lupus_g
pythius2	lupus_voc
meliboeus2	lupus
percolo2	amo
inachus2	lupus_g
glutus2	manus
tenus2	lupus_g
sophia2	vita_g1
alpheus2	lupus_g
agrius2	lupus_g
ostia2	vita_sg
pompeius2	lupus_voc
hiera2	vita_g1
uinctus2	lupus
obsero2	amo
maia2	vita_g1
festus2	virus_sg
aggestus2	manus
leaena2	vita_g2a
rutilius2	lupus_voc
lauo2	do
creta2	vita_g2
rutilus2	virus_sg