uirtus	uirtus
aetas	uirtus
dignitas	uirtus
fraus	uirtus
facultas	uirtus
hereditas	uirtus
uoluptas	uirtus
tempestas	uirtus
cupiditas	uirtus
serpens	uirtus
libertas2	uirtus
pestis	uirtus
scelus	uirtus
seruitus	uirtus
depulsio	uirtus
dolor	uirtus
uerbero2	uirtus
honor2	uirtus
error	uirtus
mens	uirtus
sermo2	uirtus
lux	uirtus
uoluptas	uirtus
uenustas	uirtus
pudor	uirtus
furor3	uirtus
tempestas	uirtus
felicitas2	uirtus
muto2	uirtus
necessitas	uirtus
punitor	uirtus
perduellio	uirtus
restitutor	uirtus
ambitio	uirtus
rumor	uirtus
occultator	uirtus
receptor	uirtus
conseruator	uirtus
acus	uirtus
libido	uirtus
recensio	uirtus
funus	uirtus
hiems	uirtus
egestas	uirtus
actor2	uirtus
maiestas	uirtus
asportatio	uirtus
ueritas	uirtus
anguis	uirtus
multatio	uirtus
obductio	uirtus
pastor2	uirtus
acer2	uirtus
fames	uirtus
imploratio	uirtus
translator	uirtus
auersor2	uirtus
creator	uirtus
communicatio	uirtus
suburbanitas	uirtus
excursor	uirtus
transactor	uirtus
caudex2	uirtus
confector	uirtus
turbo3	uirtus
exportatio	uirtus
obiurgator	uirtus
functio	uirtus
gurges2	uirtus
pignerator	uirtus
collusio	uirtus
ueterator	uirtus
prohibitio	uirtus
interitio	uirtus
improbatio	uirtus
heluo	uirtus
interrex	uirtus
gratificatio	uirtus
reditio	uirtus
bacchatio	uirtus
circumsessio	uirtus
pudens2	uirtus
diribitio	uirtus
uagor2	uirtus
datio	uirtus
portitor	uirtus
negatio	uirtus
inuestigator	uirtus
praecentio	uirtus
lues	uirtus
usucapio2	uirtus
germanitas	uirtus
deletrix	uirtus
propagatio	uirtus
auspex	uirtus
confirmator	uirtus
interceptio	uirtus
exsectio	uirtus
confectio	uirtus
tempestiuitas	uirtus
deliratio	uirtus
refrigeratio	uirtus
titillatio	uirtus
occatio	uirtus
iugatio	uirtus
religatio	uirtus
amputatio	uirtus
immissio	uirtus
saturitas	uirtus
lusio	uirtus
sido2	uirtus
appropinquatio	uirtus
conglutinatio	uirtus
peractio	uirtus
gurgulio	uirtus
impietas	uirtus
decoctor	uirtus
subiector	uirtus
occultatio	uirtus
occisio	uirtus
sauciatio	uirtus
ascriptio	uirtus
pistor	uirtus
collaudatio	uirtus
debilitatio	uirtus
abiectio	uirtus
maledictio	uirtus
pusio2	uirtus
pusio2	uirtus
manumissio	uirtus
existimator	uirtus
relegatio	uirtus
amandatio	uirtus
commentor2	uirtus
propugnatio	uirtus
puteal	uirtus
obstructio	uirtus
consortio	uirtus
deliberator	uirtus
docilitas	uirtus
declaratio	uirtus
leo3	uirtus
mutuatio	uirtus
heluatio	uirtus
conuocatio	uirtus
transmissio	uirtus
remansio	uirtus
conciliatrix	uirtus
prouisio	uirtus
uenditatio	uirtus
cooptatio	uirtus
metator	uirtus
obrogatio	uirtus
depulsor	uirtus
peragratio	uirtus
lustratio	uirtus
complexio	uirtus
compransor	uirtus
pastio	uirtus
addictio	uirtus
condonatio	uirtus
instimulator	uirtus
lapidator	uirtus
depopulator	uirtus
praegustator	uirtus
eiectio	uirtus
licitator	uirtus
uitatio	uirtus
decempedator	uirtus
perceptio	uirtus
inuectio	uirtus
eluuio	uirtus
indigens	uirtus
uisceratio	uirtus
praetermissio	uirtus
illiberalitas	uirtus
hospitalitas	uirtus
supplosio	uirtus
susceptio	uirtus
repudiatio	uirtus
neglectio	uirtus
saltatio	uirtus
interpunctio	uirtus
persalutatio	uirtus
excelsitas	uirtus
derelictio	uirtus
immaturitas	uirtus
procrastinatio	uirtus
recuperatio	uirtus
disputator	uirtus
indagatio	uirtus
aries	uirtus
colligatio	uirtus
praeparatio	uirtus
sedatio	uirtus
sessio	uirtus
fautrix	uirtus
patruelis2	uirtus
decuriatio	uirtus
debitio	uirtus
decessor	uirtus
transfusio	uirtus
decertatio	uirtus
effrenatio	uirtus
plausor	uirtus
ultio	uirtus
sopitio	uirtus
cursor2	uirtus
catenatio	uirtus
scissor	uirtus
beatitudo	uirtus
strabo2	uirtus
mus2	uirtus
anathymiasis	uirtus
stellio2	uirtus
baro	uirtus
pietaticultrix	uirtus
pedale	uirtus
sanguen	uirtus
capo	uirtus
epidipnis	uirtus
consiliator	uirtus
horror	uirtus
aequor	uirtus
auxiliator	uirtus
molitio	uirtus
sopor2	uirtus
diuitatio	uirtus
detractator	uirtus
uaticinatio	uirtus
tabes	uirtus
robigo2	uirtus
locellus	uirtus
concaedes	uirtus
conciliator	uirtus
munitor	uirtus
pauor2	uirtus
lucar	uirtus
cunctator	uirtus
consalutatio	uirtus
imaginatio	uirtus
concupitor	uirtus
concertator	uirtus
patrator	uirtus
profligator	uirtus
efflagitatio	uirtus
sanctor	uirtus
subuersor	uirtus
accumulator	uirtus
exstimulator	uirtus
popularitas	uirtus
praedatio	uirtus
flagitatio	uirtus
subuectio	uirtus
phoenix2	uirtus
prouisor	uirtus
cupitor	uirtus
condemnator	uirtus
liuor	uirtus
opacitas	uirtus
detractor	uirtus
fraternitas	uirtus
conglobatio	uirtus
monstrator	uirtus
instigator	uirtus
uenditator	uirtus
instigatrix	uirtus
stimulatio	uirtus
procacitas	uirtus
torpedo	uirtus
reputatio	uirtus
dissimulator	uirtus
narratio	uirtus
planitas	uirtus
solator	uirtus
iuuentas	uirtus
iuuentas	uirtus
turben	uirtus
textrix	uirtus
consitor	uirtus
lepos	uirtus
praelusio	uirtus
praecursio	uirtus
sinisteritas	uirtus
granditas	uirtus
commendator	uirtus
acor	uirtus
annotatio	uirtus
uiride	uirtus
arcessitor	uirtus
haesitator	uirtus
sipho	uirtus
accusatrix	uirtus
deductor	uirtus
emacitas	uirtus
uiuacitas	uirtus
elocutio	uirtus
scriptio	uirtus
indictio	uirtus
obseruator	uirtus
socialitas	uirtus
annotator	uirtus
frenator	uirtus
praesidens	uirtus
declarator	uirtus
reductor	uirtus
reformator	uirtus
obliquitas	uirtus
exesor	uirtus
amaror	uirtus
luror	uirtus
differitas	uirtus
frustramen	uirtus
dorcas	uirtus
pumilio	uirtus
cataplexis	uirtus
creatrix	uirtus
documen	uirtus
duramen	uirtus
adaugmen	uirtus
magnes2	uirtus
pestilitas	uirtus
aegror	uirtus
clinamen	uirtus
genetrix	uirtus
uocamen	uirtus
sator	uirtus
sator	uirtus
fabricator	uirtus
stringor	uirtus
excubitor	uirtus
librile	uirtus
subductio	uirtus
lignator	uirtus
lignatio	uirtus
demissio	uirtus
decliue	uirtus
alebria	uirtus
obiectatio	uirtus
incitatio	uirtus
natator	uirtus
iuuenalis2	uirtus
repetitor	uirtus
reuocamen	uirtus
laudatrix	uirtus
spectatrix	uirtus
nauale	uirtus
bubo	uirtus
imitatrix	uirtus
uulgator	uirtus
superator	uirtus
uitisator	uirtus
desultor	uirtus
ornatrix	uirtus
positor	uirtus
repostor	uirtus
curis	uirtus
curio	uirtus
praepes2	uirtus
inuentrix	uirtus
cornipes2	uirtus
lens2	uirtus
helops	uirtus
xiphias	uirtus
echeneis	uirtus
iulis	uirtus
smaris	uirtus
chromis2	uirtus
loligo	uirtus
caris	uirtus
capital	uirtus
agaso	uirtus
copis	uirtus
acceptio	uirtus
paratio	uirtus
permixtio	uirtus
portatio	uirtus
occiput	uirtus
sartago	uirtus
lactes	uirtus
senio	uirtus
cerdo	uirtus
tressis	uirtus
fossor	uirtus
ambulator	uirtus
torcular	uirtus
equile	uirtus
fortax	uirtus
usio	uirtus
similago	uirtus
ambulatrix	uirtus
depetigo	uirtus
intertrigo	uirtus
pulchralia	uirtus
uehes	uirtus
depugnatio	uirtus
eductio	uirtus
exercitio	uirtus
miratrix	uirtus
salutatrix	uirtus
subligar	uirtus
prurigo	uirtus
secutor	uirtus
gobio	uirtus
oryx	uirtus
uenatrix	uirtus
plantaria	uirtus
euocatio	uirtus
argutatio	uirtus
inambulatio	uirtus
irrumator	uirtus
aleo	uirtus
coniugator	uirtus
iocatio	uirtus
anilitas	uirtus
siluicultrix	uirtus
tutamen	uirtus
duellator	uirtus
inuolucre	uirtus
deliquio	uirtus
sartor	uirtus
eminatio	uirtus
absumedo	uirtus
amatio	uirtus
suppositio	uirtus
circumductio	uirtus
coactio	uirtus
precator	uirtus
amatrix	uirtus
receptio	uirtus
circumspectatrix	uirtus
partitudo	uirtus
tactio	uirtus
insatietas	uirtus
trifur	uirtus
maestitudo	uirtus
alec	uirtus
saeuitudo	uirtus
suauitudo	uirtus
hymen	uirtus
hymen2	uirtus
cucumis	uirtus
ianitrix	uirtus
capparis2	uirtus
consuetio	uirtus
mutitio	uirtus
parasitatio	uirtus
ominator	uirtus
praestigiatrix	uirtus
siler	uirtus
putator	uirtus
uinitor	uirtus
uomis	uirtus
bufo	uirtus
luctamen	uirtus
semihomo	uirtus
clangor	uirtus
latrator	uirtus
sandyx	uirtus
bellatrix	uirtus
pistris	uirtus
umbro2	uirtus
generator	uirtus
uirago	uirtus
debellator	uirtus
fundator	uirtus
fremor	uirtus
pugnator	uirtus
irrisor	uirtus
memorator	uirtus
marcor	uirtus
prytanis	uirtus
ceryx	uirtus
sufes	uirtus
proculcatio	uirtus
auscultatio	uirtus
hebetatio	uirtus
uectatio	uirtus
sobrietas	uirtus
pacator	uirtus
mactator	uirtus
peremptor	uirtus
refrenatio	uirtus
conuiuator	uirtus
uocator	uirtus
iniectio	uirtus
puerilitas	uirtus
praecipitatio	uirtus
dominatrix	uirtus
stuprator	uirtus
dominator	uirtus
pistrix	uirtus
sedamen	uirtus
donator	uirtus
discursatio	uirtus
numeratio	uirtus
suffossio	uirtus
nauseator	uirtus
euagatio	uirtus
tractator	uirtus
suffusio	uirtus
rectrix	uirtus
circumlitio	uirtus
propositio	uirtus
enarratio	uirtus
modificatio	uirtus
consectatio	uirtus
imprecatio	uirtus
titubatio	uirtus
palpitatio	uirtus
uastatrix	uirtus
fornicatio	uirtus
mendicatio	uirtus
cauillator	uirtus
uiolatio	uirtus
dissuasor	uirtus
irritator	uirtus
ordinator	uirtus
subministrator	uirtus
concinnitas	uirtus
fabulator	uirtus
aemulator	uirtus
firmamen	uirtus
machinatrix	uirtus
inspector	uirtus
uestigator	uirtus
stabilitor	uirtus
sugillatio	uirtus
exprobratrix	uirtus
exulceratio	uirtus
commigratio	uirtus
contemplator	uirtus
coaceruatio	uirtus
diffusio	uirtus
eiuratio	uirtus
exsolutio	uirtus
parcitas	uirtus
auersio	uirtus
deceptor	uirtus
lagois	uirtus
octussis	uirtus
cubital	uirtus
peloris2	uirtus
ador	uirtus
popino	uirtus
cessator	uirtus
siser	uirtus
modulator	uirtus
pus	uirtus
uindemiator	uirtus
promissor	uirtus
dilator	uirtus
poesis	uirtus
attagen	uirtus
terminalia	uirtus
termes3	uirtus
lenimen	uirtus
campestre	uirtus
fidicen	uirtus
fidicen	uirtus
hydrops	uirtus
temptator	uirtus
rufio	uirtus
phaselis	uirtus
hieron	uirtus
nicon	uirtus
silanion	uirtus
laenas	uirtus
bidis	uirtus
philomelienses	uirtus
tullio	uirtus
semiramis	uirtus
milon	uirtus
simulans2	uirtus
pollis2	uirtus
bambalio	uirtus
latiniensis2	uirtus
caeso2	uirtus
bardylis	uirtus
lysis	uirtus
tritonis	uirtus
glycon	uirtus
hermogenes	uirtus
agatho	uirtus
graeculio	uirtus
protogenes	uirtus
ditis	uirtus
clanis	uirtus
trinobantes	uirtus
celendris	uirtus
stratonicis	uirtus
quirinalis2	uirtus
heliopolis	uirtus
uangio	uirtus
limnatis	uirtus
cruptorix	uirtus
alcis	uirtus
hispalenses	uirtus
emeritenses	uirtus
ateste	uirtus
mefitis2	uirtus
apollinaris3	uirtus
simplex2	uirtus
simo2	uirtus
uerax2	uirtus
scydrothemis	uirtus
rhacotis	uirtus
atax	uirtus
tomyris	uirtus
theon	uirtus
soteris	uirtus
aristo	uirtus
pandion	uirtus
empedocles	uirtus
dubis	uirtus
bibrax	uirtus
bacenis	uirtus
eratosthenes	uirtus
brannouices	uirtus
segouax	uirtus
auximates	uirtus
spinther	uirtus
corfinienses	uirtus
uespillo2	uirtus
sason	uirtus
androsthenes	uirtus
tralles	uirtus
eryx	uirtus
sinis	uirtus
taenaris	uirtus
haemonis	uirtus
atracis	uirtus
arctophylax	uirtus
maeonis	uirtus
carmentis	uirtus
titienses	uirtus
ueiouis	uirtus
crathis	uirtus
semo	uirtus
tanaquil	uirtus
sopolis	uirtus
cleophis	uirtus
chares	uirtus
sittacene	uirtus
callicrates	uirtus
hystaspes	uirtus
ziobetis	uirtus
picens	uirtus
nobilior	uirtus
baucis	uirtus
mathon	uirtus
gillo2	uirtus
lachesis	uirtus
stratocles	uirtus
frusino	uirtus
hedymeles	uirtus
petosiris	uirtus
syrophoenix	uirtus
arpinas	uirtus
mycenis	uirtus
liberalia	uirtus
silo3	uirtus
sirmio	uirtus
crannon	uirtus
mauors	uirtus
zephyritis	uirtus
ficedulenses	uirtus
cordalio	uirtus
diespiter	uirtus
anthrax2	uirtus
suauisauiatio	uirtus
pellio	uirtus
uesperugo	uirtus
argitis	uirtus
hypanis	uirtus
strymon	uirtus
helenor	uirtus
arcens	uirtus
quercens	uirtus
arabs	uirtus
thestylis	uirtus
hylax	uirtus
bianor	uirtus
caulon	uirtus
periphas	uirtus
cisseis	uirtus
didymaon	uirtus
hippocoon	uirtus
thymbris	uirtus
minio2	uirtus
cupauo	uirtus
maeon	uirtus
anxur2	uirtus
dolichaon	uirtus
sacrator2	uirtus
rapo	uirtus
asis	uirtus
acanthis2	uirtus
latris	uirtus
leucippis	uirtus
edonis	uirtus
calais	uirtus
calamis	uirtus
polymestor	uirtus
cytaeis	uirtus
dolops	uirtus
chalcis2	uirtus
praexaspes	uirtus
demochares	uirtus
parrhesiastes	uirtus
antisthenes	uirtus
tanaitis	uirtus
metronax	uirtus
hippocrates	uirtus
demades	uirtus
daulis	uirtus
dracon2	uirtus
thespis	uirtus
thraex	uirtus
cotiso	uirtus
faustitas	uirtus
leno	uirtus
optimates	uirtus
uoluntas	homo
auctor	homo
oratio	homo
consul	homo
soror	homo
pater	homo
perturbatio	homo
timor	homo
uacatio	homo
miles	homo
eques	homo
contentio	homo
lex	homo
homo	homo
coniux	homo
ratio	homo
latro	homo
dominatio	homo
labor2	homo
senex	homo
praetor	homo
uox	homo
dolor	homo
defensor	homo
senator	homo
calamitas	homo
munitio	homo
oppugnatio	homo
mos	homo
rex	homo
imperator	homo
legio	homo
centurio	homo
grex	homo
frater	homo
terror	homo
honor	homo
uictor2	homo
laus	homo
augur	homo
sollicitudo	homo
error	homo
iudex	homo
exercitatio	homo
ops2	homo
quaestio	homo
sermo	homo
cognitio	homo
religio	homo
artifex	homo
censor	homo
quaestor	homo
imago	homo
scriptor	homo
cogitatio	homo
remissio	homo
amor2	homo
amor2	homo
solitudo	homo
regio	homo
dux	homo
praeco	homo
contio	homo
condicio	homo
comes	homo
orator	homo
ordo	homo
accusator	homo
mater	homo
fur	homo
propugnator	homo
uxor	homo
necessitas	homo
utilitas	homo
hospes	homo
prex	homo
seges	homo
actio	homo
occasio	homo
lapis	homo
rumor	homo
heres	homo
suspicio2	homo
uiator	homo
mulier	homo
opinio	homo
custos	homo
gladiator	homo
simulatio	homo
seditio	homo
libido	homo
possessio	homo
natio	homo
ceruix	homo
proditor	homo
satelles	homo
gratulatio	homo
creditor	homo
accusatio	homo
praedo	homo
occupatio	homo
hiems	homo
laudator	homo
uirgo	homo
meretrix	homo
mercator	homo
legatio	homo
societas	homo
nepos2	homo
pictor	homo
exsul	homo
histrio	homo
tutor3	homo
odor	homo
remex	homo
flos	homo
index	homo
lictor	homo
sacerdos2	homo
frux	homo
superstitio	homo
arator	homo
necessitudo	homo
carnifex	homo
arbor	homo
acclamatio	homo
pes	homo
gubernator	homo
pastor	homo
palus	homo
procurator	homo
procuratio	homo
uindex2	homo
cinis	homo
spectator	homo
recuperator	homo
lepor2	homo
proscriptio	homo
municeps	homo
offensio	homo
obtrectator	homo
largitio	homo
supplicatio	homo
nutrix	homo
tiro	homo
haruspex	homo
cultor	homo
obses	homo
fenerator	homo
manceps	homo
bos	homo
fautor	homo
aduocatio	homo
color	homo
pontifex	homo
nauigatio	homo
decurio	homo
simultas	homo
stipes	homo
uates	homo
delatio	homo
conditor	homo
mucro	homo
pellex	homo
iuuenis	homo
calor	homo
statio	homo
commilito	homo
pistor	homo
pedes	homo
sapor	homo
percussor	homo
leo	homo
adulatio	homo
desertor	homo
praeceptor	homo
draco	homo
aries	homo
sus	homo
factio	homo
nux	homo
delator	homo
scipio2	homo
silex	homo
cardo	homo
latex	homo
caesar	homo
cato	homo
uirtus	homo
timor	homo
pax2	homo
pietas2	homo
imperator	homo
leuitas	homo
mater	homo
mons	homo
obliuio	homo
insulsitas	homo
uirgo	homo
ereptio	homo
receptrix	homo
aurifex	homo
spoliator	homo
uerres2	homo
temperatio	homo
pons2	homo
dissolutio	homo
perpessio	homo
insimulatio	homo
dimissio	homo
ianitor	homo
praedicator	homo
locator	homo
perscriptor	homo
expugnator	homo
relictio	homo
disquisitio	homo
exstinctor	homo
excisio	homo
inflammatio	homo
explanatio	homo
epulo2	homo
enumeratio	homo
condemnatio	homo
conciliatio	homo
concitator	homo
publicatio	homo
optio	homo
optio	homo
euocator	homo
nugator	homo
accubitio	homo
compotatio	homo
concenatio	homo
morositas	homo
taxatio	homo
deiectio	homo
probator	homo
transgressio	homo
depeculator	homo
calcitro2	homo
spoliatrix	homo
balneator	homo
confictio	homo
cautor	homo
triens	homo
interfatio	homo
implicatio	homo
repressor	homo
obscenitas	homo
moderatrix	homo
altrix	homo
certatio	homo
comprehensio	homo
percursatio	homo
stupiditas	homo
spectio	homo
pensio	homo
compellatio	homo
dispertitio	homo
reuocatio	homo
admirabilitas	homo
praebitor	homo
aequatio	homo
competitrix	homo
illicitator	homo
peculator	homo
praeceptio	homo
inuentio	homo
consociatio	homo
simulator	homo
magnanimitas	homo
deflagratio	homo
tellus	homo
structor	homo
loripes	homo
cicaro	homo
domusio	homo
capis	homo
cordax	homo
uauato	homo
uilicatio	homo
cellatio	homo
notor	homo
scabitudo	homo
stator2	homo
mascarpio	homo
pensatio	homo
rebellatio	homo
firmator	homo
interfectrix	homo
abnepos	homo
abolitio	homo
uirilitas	homo
phoenix2	homo
altor	homo
pubertas	homo
criminator	homo
irritatio	homo
regnator	homo
frustratio	homo
interceptor	homo
scurrilitas	homo
dicacitas	homo
pugnacitas	homo
desuetudo	homo
constructio	homo
consummatio	homo
putatio	homo
aquilex	homo
uindicatio	homo
gracilitas	homo
gestator	homo
inutilitas	homo
putor	homo
uenator	homo
decliuitas	homo
contabulatio	homo
tabulatio	homo
iaculatrix	homo
lusor	homo
sextans	homo
cremor	homo
cultrix	homo
cerdo	homo
politor	homo
opilio	homo
matellio	homo
irpex	homo
semipes	homo
allex	homo
curculio2	homo
uiduertas	homo
uastitudo	homo
capito2	homo
duritudo	homo
plebitas	homo
fulgurator	homo
salinator2	homo
musimo	homo
spatiator	homo
euectio	homo
procliuitas	homo
compago	homo
penteremis	homo
carmo	homo
coartatio	homo
grauedo	homo
obstetrix	homo
occator	homo
festiuitas	homo
petro2	homo
uerbiuelitatio	homo
aduentor	homo
osor	homo
pollinctor	homo
hirudo	homo
malefactor	homo
contemptrix	homo
flagitator	homo
praesepis	homo
aqualis2	homo
excidio	homo
expurgatio	homo
merops2	homo
uastator	homo
insitor	homo
fluctuatio	homo
intentatio	homo
recognitio	homo
exilitas	homo
enormitas	homo
colluctatio	homo
finitio	homo
praestatio	homo
congregatio	homo
consolator	homo
unitas	homo
interemptor	homo
compensatio	homo
orbatio	homo
diuulsio	homo
elisio	homo
lippitudo	homo
feles	homo
repetitio	homo
scrutatio	homo
peloris2	homo
trigon	homo
pedo2	homo
dissignator	homo
percontator	homo
oscen	homo
philon	homo
aeschrion	homo
megaris	homo
tugio	homo
nymphon	homo
xenon2	homo
tenes	homo
plator	homo
naso	homo
lurco3	homo
agonis	homo
lycomedes	homo
timon	homo
anio	homo
sisapo	homo
laco	homo
cimon	homo
nicocles	homo
palamedes	homo
calliphon	homo
aris2	homo
felicio	homo
scylax	homo
gallio	homo
ueiento	homo
pammenes	homo
alison	homo
denter	homo
cilo2	homo
cecrops	homo
tuisto	homo
pacensis2	homo
burdo	homo
poetouio	homo
seno	homo
indiges2	homo
orgetorix	homo
uesontio	homo
aliacmon	homo
creon	homo
dryops	homo
almo	homo
adonis	homo
pelorias	homo
cleon	homo
demophon	homo
eudaemon	homo
borysthenes	homo
sucro	homo
hippon	homo
dabar	homo
ruscino	homo
naro	homo
bogud	homo
euphranor	homo
thales	homo
ursao	homo
uentipo	homo
tauris	homo
harpocrates	homo
telestis	homo
blepharon	homo
ufens	homo
arruns	homo
euphrosyne	homo
plisthenes	homo
lucretilis	homo
sextilis2	homo
discessio	homo
seruitus	homo
cognatio	homo
nobilitas	homo
multitudo	homo
uituperatio	homo
postulatio	homo
sectio	homo
subscriptor	homo
scorpio	homo
arundo	homo
gestatio	homo
lenitas	homo
atrocitas	homo
salus3	homo
salus3	homo
ciuilis2	homo
urbs	homo
pietas2	homo
grauitas	homo
rex2	homo
stupor	homo
arx	homo
senectus	homo
impunitas	homo
humanitas	homo
exspectatio	homo
admiratio	homo
tranquillitas	homo
celebritas	homo
leuitas	homo
uetustas	homo
uenustas	homo
benignitas	homo
dulcedo	homo
sedulitas	homo
praedicatio	homo
commemoratio	homo
posteritas	homo
pudor	homo
commendatio	homo
temeritas	homo
sanguis	homo
nitor2	homo
lator	homo
disceptatio	homo
canis2	homo
crudelitas	homo
improbitas	homo
festinatio	homo
tergiuersatio	homo
custos	homo
iuuentus	homo
calx	homo
aequitas	homo
uetus2	homo
immortalitas	homo
sol2	homo
imbecillitas	homo
amplitudo	homo
breuitas	homo
communio2	homo
bonitas	homo
liberalitas	homo
seueritas	homo
mentio	homo
reprehensio	homo
dispensatio	homo
decessio	homo
ostentatio	homo
splendor	homo
mansuetudo	homo
adiutrix	homo
nepos2	homo
sagacitas	homo
tutor3	homo
dubitatio	homo
pulchritudo	homo
dicio	homo
maiestas	homo
uerres2	homo
sacerdos2	homo
deprecatio	homo
ueritas	homo
partitio	homo
iurisdictio	homo
fidelitas	homo
demonstratio	homo
irrisio	homo
contagio	homo
paucitas	homo
tarditas	homo
desperatio	homo
distributio	homo
obsessio	homo
dissimulatio	homo
nundinatio	homo
facilitas	homo
frugalitas	homo
squalor	homo
longitudo	homo
integritas	homo
fames	homo
clemens2	homo
inhumanitas	homo
immanitas	homo
uindex2	homo
taciturnitas	homo
ualens	homo
uociferatio	homo
usurpatio	homo
ubertas	homo
corrector	homo
reiectio	homo
responsio	homo
aspergo2	homo
absolutio	homo
sortitio	homo
importunitas	homo
sanitas	homo
feneratio	homo
uexatio	homo
iucunditas	homo
amplificatio	homo
renuntiatio	homo
monitor	homo
indoles	homo
caligo2	homo
exactio	homo
uilitas	homo
cultio	homo
deminutio	homo
diuturnitas	homo
faex	homo
traditio	homo
subsortitio	homo
moderatio	homo
intercessor	homo
prouocatio	homo
obscuritas	homo
paupertas	homo
latitudo	homo
stridor	homo
salubritas	homo
iactatio	homo
incensio	homo
internecio	homo
ignoratio	homo
denuntiatio	homo
discriptio	homo
ambulatio	homo
calliditas	homo
lues	homo
caecitas	homo
exsultatio	homo
alienatio	homo
colluuio	homo
obsecratio	homo
interpellatio	homo
uiriditas	homo
obtrectatio	homo
obstinatio	homo
solutio	homo
humilitas	homo
suasio	homo
comparatio	homo
conspiratio	homo
ferocitas	homo
loquacitas	homo
praeuaricator	homo
prauitas	homo
imitator	homo
gubernatio	homo
probitas	homo
uanitas	homo
maturitas	homo
comitas	homo
suasor	homo
uelocitas	homo
defatigatio	homo
cruditas	homo
auiditas	homo
saturitas	homo
lac	homo
quincunx	homo
aeternitas	homo
diuinitas	homo
occidens	homo
occidens	homo
impietas	homo
alacritas	homo
trepidatio	homo
fraudatio	homo
detractio	homo
uulneratio	homo
nidor	homo
relatio	homo
infelicitas	homo
uolutatio	homo
aemulatio	homo
urbanitas	homo
migratio	homo
candor	homo
dispositio	homo
fragilitas	homo
suboles	homo
stabilitas	homo
tenuitas	homo
ignobilitas	homo
traductio	homo
contractio	homo
dictio	homo
feritas	homo
firmitas	homo
approbatio	homo
fauor	homo
contemptio	homo
imitatio	homo
confirmatio	homo
pallor	homo
impressio	homo
reuersio	homo
conseruatio	homo
claritas	homo
aequalitas	homo
intermissio	homo
securitas	homo
communitas	homo
oblectatio	homo
exstructio	homo
mediocritas	homo
foeditas	homo
fecunditas	homo
rudis	homo
nuntiatio	homo
miseratio	homo
dilatio	homo
irruptio	homo
longinquitas	homo
deditio	homo
oppressio	homo
laxitas	homo
mirmillo	homo
languor	homo
tractatio	homo
perpetuitas	homo
carbo2	homo
institutio	homo
confusio	homo
restipulatio	homo
repromissio	homo
aquatio	homo
tyrannis	homo
deformitas	homo
constitutio	homo
eruditio	homo
contemplatio	homo
editio	homo
rebellio	homo
tellus	homo
ultio	homo
pollicitatio	homo
lassitudo	homo
bucinator	homo
dispensator	homo
natalis2	homo
negotiatio	homo
ueneratio	homo
scobis	homo
turtur	homo
seruatio	homo
abies	homo
indignatio	homo
sopor2	homo
satisfactio	homo
captiuitas	homo
destinatio	homo
tabes	homo
genitor2	homo
genitor2	homo
grando	homo
cassis	homo
uigor	homo
simplicitas	homo
penis	homo
malignitas	homo
consternatio	homo
claritudo	homo
haesitatio	homo
credulitas	homo
diuersitas	homo
exsecutio	homo
firmitudo	homo
libo2	homo
uirginitas	homo
mortalitas	homo
intentio	homo
celer2	homo
rigor	homo
dignatio	homo
corruptio	homo
pernicitas	homo
coercitio	homo
continuatio	homo
emendatio	homo
paedor	homo
conuersatio	homo
scipio	homo
tenor	homo
positio	homo
torpor	homo
liuor	homo
affectatio	homo
transitio	homo
fornax	homo
fatigatio	homo
amaritudo	homo
incus	homo
anxietas	homo
cortex	homo
lepos	homo
fertilitas	homo
ordinatio	homo
intercapedo	homo
sublimitas	homo
uniuersitas	homo
scalptor	homo
siligo	homo
sinceritas	homo
austeritas	homo
andron2	homo
habitator	homo
garrulitas	homo
genetrix	homo
hirundo	homo
crassitudo	homo
exiguitas	homo
rapiditas	homo
temo	homo
contignatio	homo
cutis	homo
serenitas	homo
agilitas	homo
sesquipes	homo
sorbitio	homo
pollen	homo
capito2	homo
talio	homo
cothon2	homo
proboscis	homo
conchis	homo
iugulatio	homo
celox	homo
lento2	homo
torris	homo
modulatio	homo
oscitatio	homo
murmuratio	homo
delegatio	homo
inaequalitas	homo
aequanimitas	homo
inspectio	homo
ceres	homo
mars	homo
milo	homo
apollo	homo
iuno	homo
dis	homo
aiax	homo
hannibal	homo
glabrio	homo
turpio	homo
pollux	homo
tarraco	homo
caepio	homo
hasdrubal	homo
ligur	homo
uibo	homo
macro	homo
artemon2	homo
chilo2	homo
hiempsal	homo
pessinus	homo
straton	homo
narbo	homo
apollonis	homo
ballio	homo
rubico2	homo
sicyon	homo
otho	homo
pelops	homo
hamilcar	homo
labeo	homo
bostar	homo
byllis	homo
trimalchio	homo
chrysis	homo
asprenas	homo
segestes	homo
nar	homo
corbulo2	homo
senecio	homo
martialis2	homo
pelagon	homo
fronto	homo
tacfarinas	homo
ruso	homo
syphax	homo
ambiorix	homo
drappes	homo
macedo	homo
dumnorix	homo
cingetorix	homo
uercingetorix	homo
eporedorix	homo
rhamnes	homo
nicanor	homo
hammon	homo
agenor	homo
adherbal	homo
bomilcar	homo
aspar	homo
maro	homo
stratippocles	homo
lycon	homo
naucrates	homo
asperitas	homo
pater	homo
libertas2	homo
caritas	homo
fides3	homo
ualetudo	homo
professio	homo
delectatio	homo
celeritas	homo
merces	homo
acerbitas	homo
defensio	homo
furor3	homo
felicitas	homo
intercessio	homo
confessio	homo
petitio	homo
ambitio	homo
profectio	homo
calx	homo
cruor	homo
obliuio	homo
iniquitas	homo
antiquitas	homo
curatio	homo
aestas	homo
altitudo	homo
uas2	homo
egestas	homo
existimatio	homo
translatio	homo
testificatio	homo
auditio	homo
spoliatio	homo
indignitas	homo
uastitas	homo
inuentor	homo
obsidio	homo
carcer	homo
argumentatio	homo
proditio	homo
amissio	homo
praeses	homo
interpretatio	homo
deprecator	homo
ardor	homo
meditatio	homo
redemptor	homo
opportunitas	homo
gurges2	homo
puluis	homo
redemptio	homo
subscriptio	homo
disceptator	homo
expugnatio	homo
quies	homo
sudor	homo
siccitas	homo
suauitas	homo
euersio	homo
depopulatio	homo
amoenitas	homo
feruor	homo
panis	homo
comparatio	homo
cunctatio	homo
praeuaricatio	homo
agitatio	homo
defectio	homo
proceritas	homo
saltator	homo
rubor	homo
deunx	homo
debilitas	homo
commoditas	homo
compositio	homo
commutatio	homo
conuersio	homo
coemptio	homo
deliberatio	homo
secessio	homo
pugio	homo
collusor	homo
uomer	homo
adoptio	homo
felix2	homo
trames	homo
administratio	homo
as	homo
obseruatio	homo
precatio	homo
origo	homo
aegritudo	homo
distinctio	homo
declamatio	homo
lectio	homo
tumor	homo
paropsis	homo
quadrans	homo
electio	homo
pecten	homo
horror	homo
tonsor	homo
uenus2	homo
decor	homo
propinatio	homo
fragor	homo
persuasio	homo
pix	homo
sonor	homo
pauor2	homo
orbitas	homo
librator	homo
septentrio	homo
adiectio	homo
altercatio	homo
ilex	homo
curio2	homo
uertigo	homo
teges	homo
ambiguitas	homo
qualitas	homo
uarro	homo
cicero	homo
pollio	homo
propinquitas	homo
pax	homo
auctoritas	homo
excusatio	homo
nex	homo
dissensio	homo
magnitudo	homo
consuetudo	homo
uarietas	homo
clamor	homo
rogatio	homo
familiaritas	homo
fax	homo
laudatio	homo
tortor	homo
crux	homo
pubes2	homo
interfector	homo
sol2	homo
consolatio	homo
deuotio	homo
similitudo	homo
praes	homo
mutatio	homo
accessio	homo
emptio	homo
auctio	homo
difficultas	homo
lamentatio	homo
interpres	homo
actor	homo
fulgor	homo
adiutor	homo
uertex	homo
direptio	homo
antistes	homo
incursio	homo
coniuratio	homo
formido	homo
pactio	homo
exceptio	homo
radix	homo
exsecratio	homo
cognitor	homo
disputatio	homo
dissimilitudo	homo
cohortatio	homo
calumniator	homo
caudex2	homo
uenditio	homo
uorago	homo
possessor	homo
torquis	homo
criminatio	homo
uicis	homo
probatio	homo
mas	homo
sponsor	homo
potio	homo
significatio	homo
appellatio	homo
uapor	homo
tepor	homo
compages	homo
dos	homo
laceratio	homo
calix	homo
anser	homo
hortator	homo
tremor	homo
sal	homo
peregrinatio	homo
dedicatio	homo
consultatio	homo
pollex	homo
agger	homo
admonitio	homo
cento	homo
clunis	homo
lanx	homo
stips	homo
uenus2	homo
exhortatio	homo
strues	homo
ros	homo
liquor	homo
cupido2	homo
rector	homo
limes	homo
raptor	homo
eruptio	homo
trabs	homo
daps	homo
comperendinatio	homo
proprietas	homo
saepes	homo
caulis	homo
orchitis	homo
bacchis	homo
soror	homo
sectator	homo
quadruplator	homo
praedator	homo
direptor	homo
infitiator	homo
tubicen	homo
erogatio	homo
admissio	homo
agitator	homo
crabro	homo
strictor	homo
tubantes	homo
suessiones	homo
pictones	homo
lemouices	homo
nitiobroges	homo
uettones	homo
maiores	homo
substructio	homo
senior	homo
aratio	homo
stipator	homo
inferiores	homo
monitio	homo
piscator	homo
ueteres	homo
cornicen	homo
frutex	homo
primores	homo
defector	homo
funditor	homo
priores	homo
proceres	homo
allobroges	homo
usipetes	homo
senones	homo
uangiones	homo
bituriges	homo
carnutes	homo
harudes	homo
eburones	homo
contentio	homo
satio2	homo
damnatio	homo
dimicatio	homo
flamen	homo
dictator	homo
aedilitas	homo
turpitudo	homo
cicatrix	homo
tibicen	homo
sponsio	homo
bellator	homo
petitor	homo
descriptio	homo
diuisio	homo
interrogatio	homo
recitatio	homo
uenatio	homo
caespes	homo
salutatio	homo
euersor	homo
pronepos	homo
successio	homo
expeditio	homo
testudo	homo
nero	homo
tubero	homo
consensio	homo
honestas	homo
suffragatio	homo
timiditas	homo
uicissitudo	homo
sanctitas	homo
corruptor	homo
aestimatio	homo
reconciliatio	homo
portio	homo
uicinitas	homo
satietas	homo
sanctio	homo
infirmitas	homo
missio	homo
inclinatio	homo
fortitudo	homo
emendator	homo
nouitas	homo
fornix	homo
inscriptio	homo
praefatio	homo
sodalitas	homo
decisio	homo
notio	homo
sterilitas	homo
quaesitor	homo
caupo	homo
pulmo	homo
incolumitas	homo
stipulatio	homo
educatio	homo
nebulo	homo
hilaritas	homo
humor	homo
follis	homo
ebrietas	homo
cuspis	homo
proles	homo
conclamatio	homo
allocutio	homo
phalanx	homo
iuppiter	homo
maecenas	homo
pecus2	homo
aleator	homo
insidiator	homo
competitor	homo
sector	homo
negotiator	homo
ianitor	homo
speculator	homo
consultor	homo
amator	homo
coheres	homo
debitor	homo
auditor	homo
opifex	homo
quadrupes	homo
nomenclator	homo
lepus	homo
explorator	homo
salix	homo
procer	homo
accipiter	homo
calo	homo
promissio	homo
mors2	homo
uictor2	homo
ars	homo
ops2	homo
conformatio	homo
carmen	homo
porrigo2	homo
ustor	homo
indago2	homo
aspis	homo
recusatio	homo
adiutrix	homo
aquilo2	homo
demolitio	homo
recordatio	homo
aedificatio	homo
lenitudo	homo
appellator	homo
praescriptio	homo
irrogatio	homo
admurmuratio	homo
proditio	homo
praeteruectio	homo
dicatio	homo
consecratio	homo
adoptatio	homo
hortatio	homo
licitatio	homo
spectatio	homo
accommodatio	homo
ingenuitas	homo
restitutio	homo
diiunctio	homo
propulsatio	homo
immoderatio	homo
stipatio	homo
consurrectio	homo
instauratio	homo
coitio	homo
conquisitio	homo
abortio2	homo
congressio	homo
deprehensio	homo
pronuntiatio	homo
destitutio	homo
diuinatio	homo
expostulatio	homo
percontatio	homo
mendicitas	homo
diritas	homo
inclusio	homo
peruersitas	homo
apricatio	homo
admixtio	homo
uiduitas	homo
coniectio	homo
instructio	homo
conductio	homo
saltatrix	homo
foetor	homo
rapacitas	homo
pulsatio	homo
proteruitas	homo
prolapsio	homo
osculatio	homo
permutatio	homo
imperatrix	homo
perfectio	homo
ludificatio	homo
concertatio	homo
concentio	homo
consessor	homo
prolusio	homo
promulgatio	homo
applicatio	homo
remuneratio	homo
correctio	homo
occidio	homo
retractatio	homo
conclusio	homo
plangor	homo
fuligo	homo
collectio	homo
progressio	homo
sortitor	homo
latio	homo
interdictio	homo
fictor	homo
detestatio	homo
dissipatio	homo
nominatio	homo
praenomen	homo
explicatio	homo
apparitio	homo
conuiciator	homo
aequabilitas	homo
inuestigatio	homo
distractio	homo
disturbatio	homo
interpellator	homo
percussio	homo
consuasor	homo
reclamatio	homo
elatio	homo
uacuitas	homo
placabilitas	homo
castigatio	homo
formositas	homo
locutio	homo
submissio	homo
uolubilitas	homo
ingressio	homo
retardatio	homo
canor	homo
cento2	homo
gustatio	homo
sciscitatio	homo
promulsis	homo
margo	homo
hydraules	homo
circitor	homo
iteratio	homo
ferrumen	homo
unctio	homo
ros	homo
oscillatio	homo
epulatio	homo
castitas	homo
rudus	homo
lentitudo	homo
satias	homo
nuncupatio	homo
crebritas	homo
dissociatio	homo
designatio	homo
exprobratio	homo
infecunditas	homo
prosperitas	homo
faenus	homo
instinctor	homo
detrectatio	homo
inundatio	homo
fornax2	homo
algor	homo
nutatio	homo
exploratio	homo
conuentio	homo
toruitas	homo
traditor	homo
separatio	homo
ferrugo	homo
fel	homo
raritas	homo
bes	homo
commissio	homo
curuamen	homo
emancipatio	homo
inspectatio	homo
quantitas	homo
concussio	homo
praesumptio	homo
lemma	homo
rusticitas	homo
iaculatio	homo
profusio	homo
inanitas	homo
dedignatio	homo
castigator	homo
transuectio	homo
egestio	homo
deuexitas	homo
formator	homo
leuor	homo
contages	homo
impes	homo
molimen	homo
cupedo	homo
uexamen	homo
lanugo	homo
momen	homo
gluten	homo
maximitas	homo
mutabilitas	homo
nigror	homo
balatro2	homo
glomus	homo
accliuitas	homo
pressio	homo
stramen	homo
domitrix	homo
uultur2	homo
fulcimen	homo
proximitas	homo
acipenser	homo
escensio	homo
immutatio	homo
mirator	homo
luctatio	homo
splen	homo
plasma	homo
suber	homo
farrago	homo
cannabis	homo
centussis	homo
unguen	homo
aedificator	homo
autumnitas	homo
lucubratio	homo
oleitas	homo
aerugo	homo
scopio	homo
cantio	homo
pinguitudo	homo
podex	homo
codex	homo
iaspis	homo
tentigo	homo
lodix	homo
cyclas	homo
sufflamen	homo
ramex	homo
pytisma	homo
obscuratio	homo
macritudo	homo
eiulatio	homo
uanitudo	homo
censio	homo
seueritudo	homo
uernilitas	homo
quaesitio	homo
carex	homo
merges	homo
chalybs	homo
baccar	homo
fomes	homo
consanguinitas	homo
cos	homo
bombyx	homo
uersatio	homo
nebris2	homo
comminatio	homo
multiplicatio	homo
suffocatio	homo
auocatio	homo
reformatio	homo
deploratio	homo
sudatio	homo
pisatio	homo
quassatio	homo
formatio	homo
moderamen	homo
comploratio	homo
terminatio	homo
diminutio	homo
perscrutatio	homo
sepes	homo
ames	homo
amystis	homo
lyson	homo
mentor	homo
leon	homo
maso	homo
maeotis	homo
mutto	homo
orestis	homo
timocles	homo
uulchalo	homo
bias	homo
eros	homo
bargates	homo
hispo	homo
carrinas	homo
philopator	homo
sesosis	homo
amasis	homo
arar	homo
bibracte	homo
prusias	homo
carcaso	homo
acco	homo
gobannitio	homo
matisco	homo
pullo2	homo
arelas	homo
niseis	homo
amyntor	homo
aetolis	homo
polypemon	homo
sulmo	homo
bithynis	homo
asopis	homo
coronis2	homo
lotis	homo
arcas	homo
pallantis	homo
alpis	homo
numitor	homo
sagaritis	homo
paraetacene	homo
bagistanes	homo
mastanabal	homo
suthul	homo
theseis	homo
amydon	homo
boccar	homo
tappo	homo
congrio	homo
alcanor	homo
chaon	homo
sebethis	homo
theron	homo
poeas	homo
carneades	homo
hellas	homo
simon	homo
erro2	homo
conseruator	homo
infidelitas	homo
donatio	homo
oppugnator	homo
largitor	homo
uiuiradix	homo
insitio	homo
ganeo	homo
inquisitor	homo
educator	homo
homuncio	homo
strabo2	homo
passer	homo
coturnix	homo
coniector2	homo
coniunctio	homo
maeror	homo
aquilo	homo
turbo2	homo
animaduersio	homo
successor	homo
poples	homo
spado	homo
pauo	homo
cupido2	homo
lector	homo
grus	homo
piso	homo
circumscriptio	homo
lapidatio	homo
propago	homo
cautio	homo
obiurgatio	homo
ambages	homo
exactor	homo
obex	homo
asser	homo
suffragator	homo
auspex	homo
cursor2	homo
uexator	homo
prolatio	homo
inquisitio	homo
tiro2	homo
ereptor	homo
machinator	homo
ascriptor	homo
obsignator	homo
perditor	homo
apex	homo
trucidatio	homo
circumscriptor	homo
liberatio	homo
impuritas	homo
deprauatio	homo
circulator	homo
caduceator	homo
uiolator	homo
populatio	homo
contradictio	homo
proeliator	homo
mensor	homo
olor	homo
puls	homo
coxendix	homo
sessor	homo
aegrotatio	homo
infitiatio	homo
trio	homo
domitor	homo
emptor	homo
aestimator	homo
pugil	homo
institor	homo
periscelis	homo
ligo2	homo
repertor	homo
ductor	homo
contemptor	homo
concitor	homo
cautes	homo
computatio	homo
ultrix	homo
cauillatio	homo
conquisitor	homo
apparitor	homo
expulsio	homo
liberator	homo
obsessor	homo
conquestio	homo
doctor	homo
obsonator	homo
strix	homo
populator	homo
professor	homo
pabulator	homo
pugillares	homo
uepres	homo
aquator	homo
cotes	homo
gotones	homo
ceutrones	homo
redones	homo
sulmonenses	homo
uticenses	homo
ramnes	homo
cures	homo
occursatio	homo
caelator	homo
praediator	homo
celebratio	homo
praedictio	homo
expiatio	homo
postilio	homo
suppressio	homo
recitator	homo
irrigatio	homo
fossio	homo
repastinatio	homo
adeps	homo
perpotatio	homo
rogator	homo
diribitor	homo
effusio	homo
flexio	homo
prouocator	homo
deriuatio	homo
appetitio	homo
seductio	homo
optatio	homo
captio	homo
antecessio	homo
exanimatio	homo
glis	homo
carduelis	homo
deuersitor	homo
stator2	homo
exundatio	homo
percunctatio	homo
ruptor	homo
immolatio	homo
trudis	homo
molitor	homo
exclamatio	homo
frumentator	homo
conductor	homo
refectio	homo
ninguis	homo
machinatio	homo
ponto	homo
luctator	homo
agricultor	homo
signator	homo
proneptis	homo
cucullio	homo
subscus	homo
fraces	homo
curculio	homo
deportatio	homo
sumptio	homo
penator	homo
salinator2	homo
antes	homo
antecessor	homo
penteres	homo
derisor	homo
planipes	homo
fututio	homo
uocatio	homo
opimitas	homo
furfur	homo
edictio	homo
inductor	homo
uirgator	homo
ambestrix	homo
rogitatio	homo
dolon2	homo
natrix	homo
uellicatio	homo
ulceratio	homo
suppuratio	homo
legens	homo
respiratio	homo
destillatio	homo
uerminatio	homo
uarix	homo
unctor	homo
iurator	homo
offensatio	homo
designator	homo
unio2	homo
alucinatio	homo
risor	homo
cales	homo
baleares	homo
grinnes	homo
namnetes	homo
diablintes	homo
ueliocasses	homo
immortales	homo
berones	homo
coactor	homo
fors2	homo
expilatio	homo
deductio	homo
infirmatio	homo
curator	homo
sollicitatio	homo
concitatio	homo
moderator	homo
sutor	homo
angor	homo
ademptio	homo
declamator	homo
captator	homo
morio	homo
lien	homo
uector	homo
cornix	homo
textor	homo
pumex	homo
litigator	homo
sardonyx	homo
mango	homo
uenditor	homo
potor	homo
nepos2	homo
perductor	homo
epulo2	homo
contionator	homo
comissator	homo
cantor	homo
ministrator	homo
compotor	homo
praerogatio	homo
perscriptio	homo
origo2	homo
grassator	homo
litterator	homo
pyramis	homo
tradux	homo
rheno	homo
uultur	homo
cantharis	homo
iaculator	homo
iunix	homo
pelamis	homo
frondator	homo
praestigiator	homo
aeneator	homo
praepositio	homo
iapydes	homo
milyae	homo
agrianes	homo
athamanes	homo
tiburtes	homo
amphictyones	homo
suiones	homo
sithones	homo
cicones	homo
hesperides	homo
heliconiades	homo
santones	homo
teutones	homo
cephenes2	homo
phthiotes	homo
heliades2	homo
paeones	homo
bassaris	homo
phaeaces	homo
aonides2	homo
elias	homo
amazonis	homo
myrmidones	homo
ausonidae	homo
cephallenes	homo
bistonides	homo
diuisor	homo
carbo	homo
locatio	homo
crepido	homo
obtestatio	homo
inuitatio	homo
concessio	homo
collatio	homo
comissatio	homo
concursatio	homo
purgatio	homo
excursio	homo
impulsor	homo
definitio	homo
notatio	homo
dissuasio	homo
declinatio	homo
uastatio	homo
potatio	homo
tector	homo
uligo	homo
insectatio	homo
later	homo
pabulatio	homo
frumentatio	homo
decursio	homo
murex	homo
adhortatio	homo
conuictor	homo
gentilitas	homo
circummunitio	homo
palmes	homo
uibex	homo
imbrex	homo
pero2	homo
auersatio	homo
piscis	homo
bos	homo
libatio	homo
epulo2	homo
conscriptio	homo
consitio	homo
anser2	homo
expulsor	homo
satisdatio	homo
instructor	homo
rusticatio	homo
consectatrix	homo
ratiocinator	homo
animaduersor	homo
fartor	homo
reprehensor	homo
collocutio	homo
lanio2	homo
subsessor	homo
auceps	homo
fullo	homo
extremitas	homo
anas	homo
coctor	homo
nares	homo
leuator	homo
ostentator	homo
turbator	homo
septentrio	homo
admirator	homo
descensio	homo
scazon	homo
panax	homo
charis	homo
elephas	homo
aedituens	homo
culex	homo
balatro	homo
alces	homo
antecursor	homo
olor	homo
mormyr	homo
pardalis	homo
dromas	homo
ueles	homo
factor	homo
carptor	homo
mugilis	homo
basiatio	homo
cimex	homo
subigitatio	homo
linteo	homo
sarcinator	homo
infector	homo
incommoditas	homo
limax	homo
bucco	homo
persuastrix	homo
remeligo	homo
dator	homo
collator	homo
pedis	homo
pulex	homo
scortator	homo
spadix	homo
merops2	homo
gryps	homo
aclys	homo
aspernatio	homo
bison	homo
litigans	homo
salutator	homo
computator	homo
uomitor	homo
introductio	homo
antipodes	homo
exprobrator	homo
imputator	homo
transportatio	homo
temperator	homo
ciniflo	homo
halicyenses	homo
latinienses	homo
norenses	homo
interamnates	homo
ingaeuones	homo
istaeuones	homo
auiones	homo
eudoses	homo
suardones	homo
augustales	homo
hispellates	homo
caturiges	homo
eburouices	homo
bigerriones	homo
elusates	homo
gates	homo
cocosates	homo
tectosages	homo
caletes	homo
trinouantes	homo
ancalites	homo
oscenses	homo
illurgauonenses	homo
carmonenses	homo
byllidenses	homo
bimembres	homo
inachides	homo
luceres	homo
belis	homo
mimallonides	homo
charites	homo
corybantes	homo
acmonides	homo
nasamones	homo
argyraspides	homo
libyes	homo
uaccenses	homo
troiades2	homo
thabenenses	homo
zamenses	homo
anticato	homo
britto	homo
italicenses	homo
sortientes	homo
oceanitis	homo
proetides	homo
oreades	homo
dryopes	homo
tities	homo
nereides	homo
bistones	homo
atlantides	homo
phoronis	homo
praecursor	homo
seruator	homo
fraudator	homo
filix	homo
ueruex	homo
messor	homo
mulio	homo
finitor	homo
portitor	homo
habitatio	homo
cenatio	homo
morator	homo
adulator	homo
cocio	homo
pyramis	homo
ligures	homo
dolopes	homo
semnones	homo
magnetes	homo
iazyges	homo
aborigines	homo
uascones	homo
eumenides	homo
chalybes	homo
strophades	homo
esuritio	homo
umbo	homo
cocles	homo
atthis	homo
tempus	tempus
nomen	tempus
ius	tempus
pecus	tempus
scelus	tempus
uulnus	tempus
corpus	tempus
opus	tempus
discrimen	tempus
genus	tempus
lumen	tempus
foedus2	tempus
munus	tempus
marmor	tempus
carmen	tempus
crimen	tempus
caput	tempus
facinus	tempus
iter	tempus
cadauer	tempus
latus	tempus
limen	tempus
numen	tempus
nemus	tempus
funus	tempus
dedecus	tempus
frigus	tempus
aes	tempus
femur	tempus
pectus	tempus
flumen	tempus
litus	tempus
fulmen	tempus
certamen	tempus
omen	tempus
uolumen	tempus
semen	tempus
pignus	tempus
agmen	tempus
crus	tempus
sidus	tempus
inguen	tempus
aequor	tempus
fulgur	tempus
tempus	tempus
flamen2	tempus
diploma	tempus
tuber2	tempus
foramen	tempus
fragmen	tempus
stamen	tempus
ius	tempus
ebur	tempus
uer	tempus
fenus	tempus
abdomen	tempus
cicer	tempus
piper	tempus
stercus	tempus
iubar	tempus
regimen	tempus
iecur	tempus
gestamen	tempus
bitumen	tempus
nectar	tempus
os2	tempus
decus	tempus
robur	tempus
pondus	tempus
cognomen	tempus
tus	tempus
mel	tempus
uber	tempus
cor	tempus
examen	tempus
rus	tempus
medicamen	tempus
acumen	tempus
ulcus	tempus
papauer	tempus
murmur	tempus
cacumen	tempus
uellus	tempus
gramen	tempus
tegimen	tempus
far	tempus
culmen	tempus
os	tempus
libamen	tempus
tormina	tempus
dogma2	tempus
iusiurandum	tempus
columen	tempus
specimen	tempus
sinciput	tempus
leuamen	tempus
suffimen	tempus
bidental	tempus
allec	tempus
elauer	tempus
lupercal	tempus
onus	tempus
uerber	tempus
uiscus	tempus
uimen	tempus
uetera2	tempus
uetera2	tempus
anadema	tempus
glomeramen	tempus
uermina2	tempus
statumen	tempus
munimen	tempus
imitamen	tempus
flemina	tempus
olus2	tempus
putamen	tempus
legumen	tempus
ulteriora	tempus
hortamen	tempus
phantasma	tempus
lateramen	tempus
piamen	tempus
purgamen	tempus
fundamen	tempus
praesegmen	tempus
cantamen	tempus
ligamen	tempus
sumen	tempus
uelamen	tempus
augmen	tempus
conamen	tempus
tergus	tempus
femen	tempus
germen	tempus
solamen	tempus
uis	uis
basis	uis
sitis	uis
genesis	uis
tussis	uis
iris2	uis
tiberis	uis
neapolis	uis
leptis	uis
araris	uis
liger	uis
sicoris	uis
hispalis	uis
persepolis	uis
ucubis	uis
febris	uis
praxis	uis
peristasis	uis
proris	uis
chromis2	uis
cidaris	uis
commis	uis
orexis	uis
rauis	uis
buris2	uis
pristis	uis
pristis	uis
prytanis	uis
serapis	uis
ueseris	uis
uisurgis	uis
pompeiopolis	uis
rhescuporis	uis
philippopolis	uis
liris	uis
antipolis	uis
nemesis	uis
sabis	uis
scaldis	uis
metropolis2	uis
anubis	uis
betis	uis
pasitigris	uis
cyropolis	uis
alcestis	uis
baetis	uis
opis	uis
abaris	uis
sagaris	uis
athesis	uis
phaleris	uis
leucaspis	uis
fabaris	uis
anacharsis	uis
lens2	uis
hostis	hostis
urbs	hostis
aedes	hostis
adolescens	hostis
gens	hostis
arx	hostis
cohors	hostis
auris	hostis
ars	hostis
mens	hostis
fons	hostis
sapiens	hostis
foris	hostis
nox	hostis
uter2	hostis
sors	hostis
testis	hostis
clades	hostis
lis	hostis
moles	hostis
mons	hostis
fascis	hostis
parens2	hostis
stirps	hostis
frons2	hostis
frons	hostis
merx	hostis
uestis	hostis
cliens	hostis
dens	hostis
pons	hostis
piscis	hostis
sordes2	hostis
crinis	hostis
callis	hostis
uitis	hostis
pellis	hostis
ouis	hostis
uallis	hostis
uulpes	hostis
falx	hostis
pestis	hostis
caedes	hostis
nix	hostis
glans	hostis
uenter	hostis
postis	hostis
ensis	hostis
rupes	hostis
scrobis	hostis
sudis	hostis
axis	hostis
faux	hostis
naris	hostis
uermis	hostis
manes2	hostis
annalis2	hostis
biremis2	hostis
perduellis	hostis
auxiliares	hostis
penates	hostis
syrtis2	hostis
massilienses	hostis
locrenses	hostis
carthaginienses	hostis
catinenses	hostis
aetnenses	hostis
cretenses	hostis
samnites	hostis
uiennenses	hostis
canninefates	hostis
testis	hostis
gregales	hostis
pix	hostis
exemplares	hostis
praesaepes	hostis
thespienses	hostis
uelienses	hostis
trallis	hostis
picentes	hostis
atinates	hostis
indigetes	hostis
lares	hostis
carales	hostis
sarrastes	hostis
metamorphosis	hostis
linter	hostis
alpes	hostis
uectis2	hostis
grates	hostis
sentis	hostis
herbitenses	hostis
gades	hostis
apollonidenses	hostis
rhodienses	hostis
compes	hostis
natis	hostis
labes	hostis
conuallis	hostis
strages	hostis
fetialis	hostis
hennenses	hostis
insubres	hostis
liparenses	hostis
tissenses	hostis
ariminenses	hostis
martiales	hostis
aquinates	hostis
dorylenses	hostis
cyrenenses	hostis
aphrodisienses	hostis
stratonicenses	hostis
ilienses	hostis
cremonenses	hostis
tarracinenses	hostis
sotiates	hostis
uocates	hostis
tarusates	hostis
capsenses	hostis
cordubenses	hostis
acestenses	hostis
imacharenses	hostis
larinates	hostis
antiochenses	hostis
nantuates	hostis
sardes	hostis
siccenses	hostis
contubernalis	hostis
palumbes	hostis
atriensis	hostis
praepotentes	hostis
discens	hostis
uirentia	hostis
debens	hostis
heraclienses	hostis
gelenses	hostis
camertes	hostis
iguuinates	hostis
melitensia	hostis
hyblenses	hostis
attalenses	hostis
minturnenses	hostis
parmenses	hostis
arpinates	hostis
cerialia	hostis
iuuenalia	hostis
homonadenses	hostis
cirtenses	hostis
uspenses	hostis
ueronenses	hostis
senienses	hostis
oeenses	hostis
singulares	hostis
altinates	hostis
tolosates	hostis
anartes	hostis
apolloniates2	hostis
labeates	hostis
gomphenses	hostis
peloponnenses	hostis
quiris	hostis
cassis2	hostis
forceps	hostis
medens	hostis
confluens	hostis
canalis	hostis
ciuis	pars
consularis2	pars
finis	pars
aedilis	pars
pars	pars
familiaris2	pars
classis	pars
ignis	pars
imber	pars
funis	pars
amnis	pars
ratis	pars
triremis2	pars
sodalis	pars
collis	pars
auis	pars
agrestis2	pars
nubes	pars
unguis	pars
natalis2	pars
orbis	pars
anguis	pars
continens2	pars
supellex	pars
bilis	pars
mobilitas	pars
bipennis2	pars
tridens	pars
carthago	pars
aprilis	pars
mare	pars
textile	pars
maialis	pars
puteal	pars
promulsidare	pars
altare	pars
augurale	pars
procliue	pars
oxymeli	pars
collare	pars
tenue	pars
narnienses	pars
amphipolis	pars
soracte	pars
september	pars
par2	pars
fustis	pars
molaris2	pars
primipilaris	pars
torrens2	pars
ciuitas	ciuitas
potestas	ciuitas
lar2	ciuitas
praesaepe	ciuitas
sedes	ciuitas
mensis	ciuitas
canis	ciuitas
mus	ciuitas
uolucris	ciuitas
rudens	ciuitas
laurentes	ciuitas
mors2	ciuitas
infans	ciuitas
immunitas	ciuitas
prouincialis	ciuitas
apis	ciuitas
natales	ciuitas
prusenses	ciuitas
nicomedenses	ciuitas
atrebates	ciuitas
andes	ciuitas
insigne	mare
uectigal	mare
animal	mare
inane	mare
turpe2	mare
mare	mare
monile	mare
tribunal	mare
cubile	mare
sollemne	mare
ouile	mare
praesentia2	mare
moenia	mare
caelestia	mare
mapalia	mare
utensilia	mare
mortalia	mare
puluinar	mare
praeceps3	mare
conclaue	mare
campestria	mare
hastile	mare
commune	mare
exemplar	mare
sublime	mare
calcar	mare
pingue	mare
altar	mare
munia	mare
parentalia	mare
naualia	mare
uitalia	mare
equestria	mare
obstantia2	mare
hostile	mare
missile	mare
laquear	mare
uiride	mare
dentale	mare
nouale	mare
megalesia	mare
saturnalia	mare
uinalia	mare
funale	mare
lupanar	mare
penetrale	mare
sedile	mare
consequens	mare
cochleare	mare
toral	mare
uirilia	mare
feralia	mare
muliebria	mare
ramale	mare
suouetaurilia	mare
triste2	mare
bacchanalia	mare
agonia2	mare
breue	mare
mantele	mare
bubile	mare
molile	mare
fabalia	mare
quadrantal	mare
incile	mare
pugillar	mare
fenilia	mare
magalia	mare
talaria	mare
accidens	mare
missilia	mare
lugubria	mare
focale	mare
cerealia2	mare
floralia	mare
parilia	mare
agnalia	mare
larentalia	mare
fornacalia	mare
ceruical	mare
rete	mare
minutal	mare
forensia	mare
septentrionalia	mare
fictile	mare
insilia	mare
mortualia	mare
palear	mare
matralia	mare
palilia	mare
lacunar	mare
prominens2	mare
praeneste	mare
tibur	mare
paries	lux
lux	lux
quinqueremis	lux
quadriremis	lux
riualis	lux
caro	lux
corbis	lux
nauis	nauis
securis	nauis
turris	nauis
febris	nauis
puppis	nauis
sementis	nauis
messis	nauis
clauis	nauis
restis	nauis
peluis	nauis
neptis	nauis
mephitis	nauis
animans	animans
guttur	guttur
