Abantius	     Abantian (i.e. Euboean).
Acarnanus	     Acarnanian.
Achaeias	     Greek.
Achaemenius	     Achaemenian (i.e. Persian or Parthian).
Acte2	     Old name of Attica.
Adonium	     (Used erroneously by Pliny in 
Aeacides	           Ann.
ccAegates	        ~es insulae
Aegyptiacus	     Connected with or concerning Egypt.
Aegyptus1	        Egypt.
Aethalis	     Aethalian (from its Greek name).
Aethiopus	     Ethiopian.
Aglaie	     One of the Graces.
Agricola2	     Cognomen of 
Agrippa	        CIL
Agylla	     Former name of Caere.
ccAgyllinus	       urbs ~a
Aleius	       ~i campi
Aliarius	       Compitum ~um
Alidensia	     (apparently) Garments made at Alinda in Caria.
ssAllobrox	     (pl.) A tribe in 
ccAlsietinus	       Lacus ~us
Ambracius	     Ambracian.
Amphilochius	        Amphilochian.
Amyclides	     Hyacinthus, who was worshipped at Amyclae.
Ancus2	     (in full 
Antilibanus	     (usu.) 
Aones	     Boeotian.
Apollo	     Orthography 
Arabs2	     Arabian.
Arcas2	     Arcadian.
Archiacus	     Made by Archias (apparently as being typically plain).
ccAremoricus	       ~ae ciuitates
Argus2	     (apparently) Argive.
Ascanius2	     (in substantival or quasi-substantival geographical names)
Asiagenus	        Cornelius Scipio, consul in 190 bc (cf. Asiāticus).
Asias	     Asia, the East.
Asopius	     Descended from Asopus.
Atellanicus	     Belonging to Atellan farce.
Athena	         58.7). The goddess Athena.
ccAtlantios	       nodus ~ios
Auentinus1	         Sil.
Babyloniacus	           Babylonian.
Babylonicus	           Babylonian.
Babyloniensis	           Babylonian.
Berecyntiades	           Berecyntian (cf. Berecynthius).
Bioneus	           Characteristic of Bion, i.e. satirical.
Bisaltis	           Theophane, daughter of Bisaltes.
Bistonius	           Bistonian, Thracian.
Bituriges	            . A people of Aquitania.
Boeoticus	           Boeotian.
Boeotis	           Boeotia.
Boius	             Pl. Boiī or Boī
ccBorysthenius	           (  ~us amnis
Britanni	              Orthography 
Britannus	           British.
Buthrotum	               and 
Byzantiacus	           Byzantine.
Calabricus	           Calabrian.
Calchedonensis	            {v= Calchēdonius.}
Calydoneus	           Calydonian.
Calydonis	           Calydonian; (as noun) a Calydonian woman; (spec.) Deianira.
Campanianus	           Situated in Campania.
Capaneus1	     e͡i		{ge = ~e͡i, pos = m.} del3
Cappadocicus	           Cappadocian.
Cappadocius	           Cappadocian:
Carchedoniacos	           Carthaginian.
Caryatides	           Marble statues of women used as pillars in temples, etc.
ccCascellianus	             iudicium ~um
Cassandra	             (  Quint.
Cebenna	              {pos=(pl.)} or 
Ceubennae	{pos = pl.,v=Cebenna}
ccCebennicus	             ~i montes
Cecropia	           Athens.
Celtiberice	        In the Celtiberian language.
Celtica	           Celtic country.
Celticus	           Celtic; 
Cenomani	                 9(1)). A Gallic tribe.
Cepheis	           Daughter of Cepheus, Andromeda.
Cepheius	           Descended from Cepheus.
Chios	               Forms 
Chironium	               Centaury, 
Christiani	           Followers of Christ, Christians.
Christus	           Christ.
Cimbrice	        In the Cimbrian language.
Cimmericus	           Cimmerian.
Cimolus	           One of the Cyclades.
ccCiprius	              uicus ~us
Cliuicola	           (apparently) A god presiding over slopes.
Corinthiacus	           Corinthian.
ccCorycides	             ~es nymphae = Coryciae nymphae
Cydonaeus	            Cydonian; (especially, as poet. epithet for arrows, etc.) Cretan.
Cyrenae	                    7.4;   Verg.
Dacius	           Dacian.
ssDalmatae	             Delm-
Damascena2	           Plums (
Dardanis	           Trojan.
Dardanus2	           Dardanian, i.e. Trojan; (m. as noun) a Trojan; (neut. as noun) = Dardania b.
Daunias	        (as noun) Daunia, Apulia.
Deliacus	           Born or living in Delos, Delian.
ccDia2	             Dea ~a
Diocleus	           Named after Diocles, fourth-century bc Greek physician.
Diomedeus	              Belonging to or connected with Diomedes (see Diomēdēs 1).
Dis2	     {inflection =Dītis, pos = m.} delf3
Dolabellianus	           Named after a Dolabella.
Dorice	        In the Doric dialect.
Doris2	           Dorian, Doric; also, Greek (as opposed to Trojan).
Elidensis	            . Of Elis, Elean.
Fanester	           Of 
ccFerentina	             Aqua ~a
ccFeronius	             Picus ~us
ccFiculea	              (  ~a uetus
ccFlumentanus	             Porta ~a
Gaius	           Forms 
Galilaea	           Galilee.
Galla3	           used by Catullus for 
Gallograecia	           Galatia.
Gallograecus	           Galatian; (also m. as noun).
Gallus3	           Gallic; (probably also) Galatian.
ccGenita2	             ~a Mana
Geryon	                     delf13
Getice	        In the Getic language.
Gnosias	           {v = Gnōsis}
Graeciensis	           Grecian, Greek.
Hebraeus	           Hebrew, Jewish.
Helladicus	           Hellenic.
Hellespontias	     {ge= -ae}	 delf4
ccHercynius	             silua ~a
Herem	        (apparently) An Italian goddess (cf. Heriem).
Hermes	   {inflection = ~ae, pos=m.} delf4
nnvvHerma	{inflection = ~ae, variant_of=Hermes}
Hibericus	           Iberian, Spanish.
Hibernia	           Ireland.
Hispane	        In the Spanish manner.
Horconia	           {inflection=~ae}
nnvvHolconia	{variant_of=Horconia}
Hymen	     Ov.
Ianigena	           Born of Janus.
Iapygius	           Iapygian.
Iapyx2	        Iapygian.
Iastius	           (music) Ionic.
Icelus	             Marcianus ~us
Iguuini	           {v = Īguuīnātēs}
Ion2	     {inflection=Ĭōnos; Ĭōnis} 
Ioniacus	           Ionian.
Ionis	           Ionian.
Ismara	                  a  delf9
Iuuerna	           Ireland.
ccLarius	             ~us lacus
ccLatiniensis	             ager ~is
Latinum	           Latin speech, Latin.
Laus2	             Laus Pompeia
Lausus	           (mythology)
ccLemannus	             lacus ~us
Lesbiacus	           Lesbian.
Lesbous	           lesbian.
ccLibanus	             mons ~us
Libyaticus	           (Hypothetical word for Libycus formed on analogy of 
Libystinus	           African.
Libystis	           African.
Liguscus	           Apparently variant of Ligusticus.
Lips	     {ge=Libis; Libos}
ssMacae	           (sg. 
Macareis	           (myth.) The daughter of Macareus.
Macedonia	           Macedonia.
Macedonianus	           (  senatus consultum
Macedoniensis	           Macedonian.
Maeuius	           (leg.) A conventional personal name.
Malea	           Perhaps also  delf9
nnvvMalēae	{inflection=~ārum, pos = f. pl., variant_of=Malea}
nnvvMalēum	{variant_of=Maleae}
Maleum	           Cape Malea.
ccMaliacus	         {pos=adj.} sinus ~us
Maro1	           The 
Massylus	           Massylian, (often poet. for) African.
Maurusiacus	           Moorish, Moroccan.
Mazaces	              . A Numidian tribe.
Megara1	                      a
Melanippa	       {inflection=~ae; ~ē; ~ēs}
ccMerica	             uitis ~a
Midas	           (mythology) A Phrygian king who, as a reward from Bacchus, turned to gold all that he touched; he was punished for his insensitivity to Apollo's music by being given ass's ears.
Milo2	           A 
Mimalloneus	           Bacchantic.
Moesicus	           as Moesiāticus.
ccMoschicus	             mons ~us
Moyses	            Moses, the Jewish lawgiver.
ccMugio2	              porta (portae) ~onis
Mummianus	           Named after a Mummius.
ccMurcius	              metae ~ae
ccMyrtous	             mare ~um
Mys2	     {ge= Myos}
iivvMytilenensis	            = Mytilēnaeus.
Narbo	           (in full) 
ccNartes	             Interamnates ~es
Nasamonias	           Nasamonian.
Nasamonius	           Nasamonian; (in quotations, poet.) African, Libyan.
ccNicolaus	             palma ~i
Nioba	              Niobe, daughter of Tantalus, whose many children were killed by Apollo and Artemis because she boasted she was Leto's equal; she turned to stone with weeping. 
Nisus2	           (mythology) A king of Megara, betrayed by his daughter Scylla; he was turned into a sea eagle.
Nomades		               delf11
Nomas	{inflection=~adis; ~ados, pos= m. f.}
Nysigena	           Born on Mount Nysa, birthplace of Bacchus.
Oceanis	          , Oceanid.
Ops2	     {ge=Opis}
Opis		{variant_of=Ops2, ge=Opis}
Orchomenos	                           Nat.
ccOrcinianus	             sponda ~a
Otos	            One of the Giants.
Pagasicus	           as Pagasēius.
ccPallacina	             uicus ~ae 
ccPalmensis	             ager ~is
Panchaeus	           Panchāius.
Panda	            . A Roman goddess.
ccPandanus	             ~a porta
Panici	           (Humorous coinage to suggest 'bakers' with pun on (perhaps) 
Pannonis	           Pannonian.
Panope1	              One of the Nereids.
Pantica	           another name for Panda.
Paphlagonius	           Paphlagonian.
Paphos1	           
Paros	               One of the Cyclades.
Parthis	           Parthian.
Patara	             {number=mostly plural}
ccPaterclianus	             sellae ~ae
Paulinus	                      Suetonius Paulinus, governor of Britain ad 58-61.
Pelasgias	           Pelasgian.
Pelasgicus	           Pelasgian.
Pelasgis1	           Pelasgian.
Peleus1	           Forms 
Pelorias	           as Pelōriadēs.
Peloris1	           as Pelōrias.
Pergama	              . The citadel of Troy.
Persaeus	           {variant_of= Persēus2}
Persice	        In the Persian language.
Persis2	           Persian.
Perusinus	           Of, coming from, or connected with Perusia in Etruria; (m. pl. as noun) its inhabitants; (neut. as noun) an estate near Perusia.
ccPetelinus	             lucus ~us
Phaeacia	           (mythology) A land (sometimes identified with Corcyra) where Odysseus was entertained by King Alcinous.
iivvPhalanthinus	            = Phalanthēus.
Phoeniceus2	           Phoenician.
Phoenicius2	           Phoenician.
Phoenissa	             {pos=neut. adj.}
Phoenix2	           (mythology)
Phrygius	           Forms 
Phryx	           Forms 
Piericus	           Pierian 
Pithecusa	           
Pitthides	   {inflection=~ae}
Pluuialia	           One of the 
Podarce	           One of the Harpies.
Polydamanteus	           Belonging to Polydamas.
Polydoreus	           Belonging to Polydorus.
Populonia2	                  a  delf9
zzz
Porphyrion	           One of the giants.
Porsenna	                Lars~a
Potitus	           A 
Procrustes	           (mythology) An Attic robber who waylaid travellers and fitted them to his bed either by stretching their limbs or by lopping them.
Pulcher2	                  Clodius Pulcher, tribune 58 bc.
Punice	         In the Punic language.
Puniceus2	            Carthaginian, Punic; 
Pythicus	           Pythian, Delphic.
Quadrigarius3	           A 
Raudius	             campus ~us
Raudusculana	           = Rauduscula.
Raurica	           A 
Regillum	                    a
Rex2	     Rēgis
Rumina2	             ficus ~a
Runcus	           Some mythological figure 
Sabine	        In the Sabine language.
Salarianus	             castanea ~a
Sambracenus	             murra ~a
Sardiniensis	           Sardinian.
Sardous	           Sardinian.
Sarmatice	        In the Sarmatian language.
Saronicus	             sinus ~us
Scironius	             saxa ~a
Semo	             ~o Sancus
Seplasia	                     , were sold.
Seruitius	             uinum ~um
Sicanis	           Sicilian.
Sicanius	           Sicilian.
Sicelis	           Sicilian.
Siluana	           a f. counterpart of Siluānus.
Sinopis	           Red ochre found near Sinope.
Sipus	             (?neut.)
Spania	           Spain.
Spartiacus	           Spartan.
Spinther	           A 
Stata	           (also 
Stellas	             campus (ager) ~as
Styx	     Stygis or Stygos
Subballio	           (facetiously coined name for a servant of Ballio, probably with pun on some unidentified word).
Sulla	           Sometimes written 
Sullanus	           Sometimes written 
Sybaritanus	           Belonging to Sybaris.
Synnada	                  a
Syriscus	           Feminine 
Taenarus	                     marble.
Tanagricus	           Produced, reared, etc., in Tanagra.
Tanaiticus	             mare ~um
Taras	            = Tarentum1.
Taratalla	        humorous name derived from Homer 
Taygete	              One of the Pleiads.
Taygetus	                  a
Tepulus	             aqua ~a
Teutoni	           Rarely sg. 
Thebogenes	           Springing from Boeotian Thebes.
Thebris	   old form (probably Etruscan) of Thybris1, Tiberis.
Thelis	            old form of Thetis.
Themistocleus	           Characteristic of Themistocles.
Therodamanteus	           (apparently) Of Therodamas, a Libyan prince who fed his lions on human flesh.
Thessalis	           Thessalian.
Thrace	                = Thrācia.
Thracus	            = Thrācius. 
Thraecia	   see also Thrācia etc.
Thressa	             Thraessa
Thynicus	            = Thȳniacus.
Tigellinus	           C. Oforius Tigellinus (d. ad 69), 
Timoneus	           Appropriate to Timon.
Tingitanus	             provincia ~a
Tisiphone	           One of the Furies.
Titianus	           Named after a Titius.
Titiensis	             tribus ~is
Togatenses	             traiectus ~ium
Tomis2	                    a
Toronaeus	             sinus ~us
Trasumennus	           Forms 
Treueri	              Trēuer
Trinacris	           Sicilian; 
Tritoniacus	           Associated with Tritonia (Athena).
Tyrrhenia	           Etruria.
Tyrrhenicus	            = Tyrrhēnus; especially 
Ualerianus	           Belonging to a Valerius.
Uarus4	                  a
Ubii	              ,   ~a
Uenetus2	             locus ~us
Uertumnus	              a
Uesianus	             opus ~um
Uesuuius	                mons ~us
Uica Pota	     Vicae Potae
Umbricus	           Umbrian.
Uolcanalia	           Forms 
Uoltumna	           (or 
Urbius	             ~us cliuus
absilio	     (also 
acceptator	     (agent noun from 
aequus	      Forms 
agaga	     (vulg.; perhaps) A catamite.
agnomentum	      = agnōmen.
agricolatio	     Agriculture.
agrosius	     (dub.) Possessing land.
ai	     (an expression of grief) Ah! alas!
albus	     according to 
alternabilis	     (conjecture for aeternābilis)
ambrosialis	     ? Ambrosial? Connected with 
an2	       in same sense; 
animaduerto	          N.B.: 
antehac	     hac
apiacon	     (apparently an error for apiacus, for which Cato is Pliny's authority).
apsinthius	      (apparently) var. of apsinthium.
aroscit	     (dub. word, explained as =  πλανᾶται ).
ater	          atrior. 
atterraneus	   (dub.) 
balneum	            Often heteroclite pl. 
barbasculus	           (perhaps) A whippersnapper.
bene	          melius, optime
bolus2	               or 
bos	     bouis
bryonia	            (  alba ~a
cado	     ~ere, cecidī, cāsum
caepaticus	   (  cj.
calamistrum	              in 
calco	             (intr.)
caliculus	           (see also 
calor	             (neut.)
calpar	       (probably) 
caluaria2	     (? ~ium)
cancer1	           also 
carbasus1	               In pl. 
carex	           Reed grass or sedge.
carinarius	     (dub.) ~iī
carino2	               ~ārī
cauium	   (apparently corrupt word in 
caulae	           (  caullae
caullator	           (apparently used comically for 
cedo2	   (  pl. cette
cerceris	           or 
cerno	     ~ere, crēuī, crētum
chartus	            = charta.
chelium	   (s.vv.ll.) 
cieo	     ciēre, cīuī, citum
ciprus	        apparently Sabine = 
circulus	                 trag.
circumago	             (intr.)
circumeo	             (intr.)
circumuector	               ~āre
citer	     ~era, ~erum, citerior, citimus
claro	             (intr.)
claudeo	     ~ēre, clausum
clipeus	                       in 
clutus	           (perhaps word invented to connect Greek κλυτa2 ς with 
codicillus	                 Ep.
cogo	     ~ere, coēgī, coactum
colliquiaria	        (  cj.
collusim	   (dub.) 
colo1	             (intr.)
colossicus	             Comparative (as Greek) ~ōteros
comitor	             (intr.)
committo	             (intr.)
compectum	             conp-
comperio	             conp-
compitum	             conp-
comploro	             (intr.)
comprehendo	             (intr.)
concapit	        dub. word in 
confio	           (collateral with pass. of 
confiteor	             (intr.)
confore	          confutūrus.
conicio	             (intr.)
coniunx	      ~ugis
consocio	             (intr.)
constituo	             (intr.)
consum	   only in forms confore, 
consummo	             (intr.)
contemplo	       and 
continuo2	             (intr.)
contor	   (dub.) 
conuerto	             (intr.)
cops	     cōpis
cor	     cordis
cordax	             (adj.)
cresco	     ~ere, crēuī, crētum
crocotillus	           (apparently) Very thin (but cf. 
crucio	             (intr.)
cudo1	     cūdere (cūdī, cūsum
cuiusnam	     cūianam, cūiumnam
cuiusuis	     cūiauis, cūiumuīs
cummi	     ~is
curo	             (intr.)
damnigerulus	           (facet. compound of 
debeo	             (intr.)
decor2	       (? or 
decuma	   see also decima1 etc.
defero	     ~rre, dētulī, dēlātum
delibo	             (intr.)
deliramentum	           In codd. also 
deminutio	           (In codd. written 
denuntio	             (intr.)
depello	             (intr.)
deploro	             (intr.)
depropero	             (intr.)
depubem	   (accusative) 
deuito	             (intr.)
deus	     deī
differo	     ~rre, distulī, dīlātum
diiudico	             (intr.)
dirigo	             (intr.)
dis1	     dītis
disco	     ~ere, didicī
discrepito	     āre
disex	     dīsice (ablative).
disrumpo	   see also dīrumpō etc.
do1	     dare, dedī, datum
doleo	               ~eunt
dos	     dotis
echo	       (accusative) 
edisco	     ~ere, ēdidicī
edo1	     esse, ēdī, ēsum (essum)
effero1	     ~rre, extulī, ēlātum
efferuesco	     ~ere, efferuī
efflo	             (intr.)
effor	             (intr.)
effringo	             (intr.)
eicio	     ēicere, ēiēcī, ēiectum
elauo	             (intr.)
eloquor	             (intr.)
eludo	             (intr.)
eluo	             (intr.)
emereo	             (intr.)
emo	     emere, ēmī, emptum
eo1	     īre, iī or īuī, itum
epicrisis	       (accusative) 
exfafillatus	           (dub.) (apparently) Stuck or thrust out.
exhalo	             (intr.)
exilico	   corrupt word in 
expergiscor	     ~ī, experrectus
exposco	     ~ere, expoposcī
expurgo	             (intr.)
exsequium	            = exsequiae.
exsisto	     ~ere, ex(s)titī
exsto	     ~āre, ex(s)titī
exsudo	             (intr.)
exsum	     exesse
exter	     ~era, ~erum, exterior, extimus, extrēmus
extrilidus	           (Doubtful word in 
exussus	   dub. word in 
facio	     ~ere, fēcī, factum
faex	     faecis
falsus	           (both rare, cf. 
farfenum	           (probably corruption of farfarum).
fateor	     ~ērī, fassus
fax	           perhaps also 
fero	     ~rre, tulī, lātum
ferueo	     ~ēre, ferbuī
fido	     ~ere, fīsus
findo	     ~ere, fidī, fissum
finio	             (intr.)
fio	     fī̆erī
flecto	             (intr.)
fodio	     ~dere, fōdī, fossum
foliaceus	           Sometimes written 
for	     fārī, fātus
foras	        (and 
fore	   =   futurum esse
forem	     ~es, etc.
formido1	             (intr.)
foueo	     ~ēre, fōuī, fōtum
fracesco	     ~ere, fracuī
frendo	     ~ere, frēsum
frigesco	     ~ere, frixī
frigida	             ⋈22  Ɔ     ~a non laui magi' lubenter 
fucillans	           dub. word in 
fugio	     ~ere, fūgī
fundo1	     ~ere, fūdī, fūsum
fusco	             (intr.)
galactites	       (accusative) 
galbeolus	           (apparently) = Merops1, the bee-eater.
gau	   shortened from gaudium (according to Ausonius 349.3).
gaudeo	     ~dēre, gāuīsus
gausape	       or 
gemino	             (intr.)
gesto	             (intr.)
gigno	     ~ere, genuī, genitum
gingilipho	   word of unknown meaning.
glandionida	           comic patronymic based on next.
glubo	     ~ere (glupsī, gluptum)
gradior	     ~ī, gressus
grandio	             (intr.)
graphice1	        Sometimes written 
habeo	             (intr.)
hahae	        expressing joy, amusement, etc.
halagora	        unknown word used as term of abuse.
halophanta	              (Unknown word, perhaps humorous formation, indicating a dishonest person of some kind.).
helica	           (  cj.
hercle	     hercule
hermaphroditus2	           Hermaphrodite, combining characteristics of both sexes.
hic1	     haec, hoc
hidros	   (dub.) 
idem	     eadem, idem
ignoro	             (intr.)
immergo	             (intr.)
immoueo	   (dub.) 
immunis	             inm-
immuto	             (intr.)
impancro	            (=   inuado
impedio	             (intr.)
impingo	             (intr.)
impono	             (intr.)
imprecor	             (intr.)
incerno	     ~ere, incrēuī, incrētum
incoho	             (intr.)
incommodesticus	           comic enlargement of incommodus.
incuso	             (intr.)
indignor	             (intr.)
indipiscor	     ~ī, indeptus
indoloria	           quoted by Sidonius Apollinaris (
ineo	             (intr.)
infitior	           Sometimes written 
insisto	     ~ere, institī
inspicio	             (intr.)
insum	     inesse, infuī
intellego	             (intr.)
intero1	     ~ere, intrīuī, intrītum
interrogo	             (intr.)
intueor	             (intr.)
inuiso	             (intr.)
inundo	             (intr.)
ion3	     ĭōnos (-is)
irascor	     ~ī (īrātus)
irroro	             (intr.)
is	     ea, id
iugo2	   (? or 
ius1	     iūris
ius2	     iūris
iuuo	     ~āre, iūuī, iūtum
lac	     lactis
lallo	           (perhaps also 
lapathium	            var. of lapathum.
laridum	            lardum
lauatrina	             ⋈22  Ɔ       Pompon.
laxo	             (intr.)
lego2	     ~ere, lēgī, lectum
lenio	             (intr.)
lex	     lēgis
lingo	     ~ere, linxī, linctum
lino	     ~ere, lēuī, litum
linquo	     ~ere, līquī
liqueo	     ~ēre, licuī or liquī
lis	     lītis
loquor	     ~ī, locūtus
luca bos	     lūcae bouis
luceo	     ~ēre, luxī
ludicer	     ludicra, ~crum
lugeo	     ~ēre, luxī, luctum
lupus	             (?f.)
lustro1	             (intr.)
lux	     lūcis
lynx	     lyncis or lyncos
macto	             (intr.)
magis1	          maximē.
magistro	             (intr.)
magno opere	     maximopere
male	          pēius, pessimē
maledico	               Often as two words 
malefacio	           Often as two words 
mammia	           Perhaps also 
manicae	           -cae
mantiscinor	           (word of dub. meaning).
mas1	     maris
mas2	     maris
materfamilias	     mātrisfamiliās
materinus	           (dub. word, derived by some editors from 
meio	     ~ere, mixī or minxī, mictum or minctum
mel	     mellis
meltom	        (probably f.l. for 
menias	   dub. word in 
mereo	             (intr.)
merito2	             (intr.)
metior	     ~īrī, mensus (mētītus)
meto2	     ~ere (messuī) messum
metuo	             (intr.)
mia	          chariton ~a
minimus	                1   Smallest (or very small) in size or extent.
miniscor	         (mentus)
minuo	             (intr.)
misceo	     ~ēre, ~uī, mixtum (mistum)
miseror	             (intr.)
mitto	     ~ere, mīsī, missum
molesto	             (intr.)
molior	             (intr.)
mordeo	     ~dēre, momordī (mem-), ~sum
mos	     mōris
moueo	     ~ēre, mōuī, mōtum
mulceo	     ~ēre, mulsī (mulsum or mul(c)tum)
muriola	               murr-
mus	     mūris
muto1	             (intr.)
myrice	   (?  myrīca
mys1	     myos
nanciscor	     ~ī, nactus or nanctus
nascor	     ~ī, nātus
nauplium	           (apparently) An article, probably of dress or adornment, used in Isis worship.
necne	          negative particle
necto	     ~ere, nexī, nexum
nego	             (intr.)
neo	     nēre, nēuī, nētum
nequam	          nēquior, nēquissimus.
nescio	             (intr.)
nex	     necis
nix	     niuis
no	     nāre, nāuī
nosco	     ~scere, nōuī, nōtum
nouo	             (intr.)
nyctalops	             (?f.)
obeo	             (intr.)
obnuntio	             (intr.)
obruo	             (intr.)
obseruo	             (intr.)
obsidianus	   apparently erroneous for obsiānus.
obstino	             (intr.)
obstruo	             (intr.)
obsum	     ~esse, ~fuī (also offuī)
obtineo	             (intr.)
obumbro	             (intr.)
occursatrix	           (Feminine agent noun from occursō).
offero	     ~rre, obtulī or optulī, oblātum
offirmo	             (intr.)
ollaner	   dub. word in 
omniparens	             (adj.)
oppugno	             (intr.)
ops1	     opis
ops3	     opis
optimates	             optum-
orichalcinus	           In quotation 
os1	     ōris
os2	     ossis
oscheos	           (or 
oscillo	           Perhaps also 
osculor	             (intr.)
paedagogium	     ~iiV2 
pallo	           (unintelligible word in 
palpo	             (intr.)
palpus	           (or? 
panaca	   (  ? ~ae
pando2	     ~ere, passum or pansum
pango	     ~ere, pepigī (or pēgī, panxī), pactum
par1	     paris
par2	     paris
par3	     paris
parco	     ~cere, pepercī (or parcuī, parsī)
parembolis	           (? or 
pario2	             (intr.)
parnacis	           (apparently) A garment worn by girls.
parum	          indeclinable adv.
passiolus	            of phasēlus 
pax1	     pācis
pecto	     ~ere, pex(u)ī, pexum (~itum)
pendeo	     ~ēre, pependī
peragro	             (intr.)
percurso	             (intr.)
perenno	             (?tr.)
pererro	             (intr.)
perfacul	   archaic for perfacile.
perfero	     ~rre, pertulī, perlātum
pernocto	             (?tr.)
peronei	   dub. word in 
perpluo	             (?tr.)
pertaedeo	             (intr.)
pes	     pedis
pessimus	           to malus1.
piget	             (intr.)
pinnus	   (? or 
pix1	     picis
pix2	     picis
plango	             (intr.)
plebiscitum	           Often as two words (sometimes separated or reversed) 
pono	     pōnere, posuī, positum
poricino	        obscure word in 
posco	     ~ere, poposcī
possum	     posse, potuī
praegrauo	             (intr.)
precor	             (intr.)
precula	   a barbarism for pergula.
premo1	             (intr.)
profringo	     ~ere, prōfrēgī, prōfractum
proicio	             (intr.)
promereo	             (intr.)
propala	        dub. reading in 
pruditas	           (dub. word in 
psin	   = Greek ψίν (
puluero	             (intr.)
pungo	     ~gere, pupugī (pepugī), ~ctum
pus1	     pūris
putiluci	           comic perversion of puticulī.
pyropum	           (or 
pyrricha	     pyrrhicha
quaero	             (intr.)
quantillus	           How small in amount, size, etc.? (in quotations, exclamatory).
quantusquantus	     quantaquanta, quantumquantum
quasso	             (intr.)
quattuoruir	           Abbreviated 
quattuoruiralis	           Abbreviated 
quattuoruiratus	           Abbreviated 
quemadmodum	        Often written as three words, by editors sometimes as two (
queo	     quīre, quīuī or quiī
qui1	     quae or (sense 24) qua, quod
quicumque	     quaecumque, quodcumque
quidam1	     quaedam, quoddam
quidam2	     quaedam, quiddam
quiens	     queuntis
quiesco	     ~ere, quiēuī, quiētum
quilibet1	     quaelibet, quodlibet
quilibet2	     quaelibet, quodlibet
quinam	     quaenam, quodnam
quini	           Rarely sg.
quique	   in phrase 
quirquir	   obscure word in augural formula cited in 
quis1	     quid
quisnam	     quaenam, quidnam
quispiam1	     quaepiam, quodpiam
quispiam2	     quaepiam, quippiam (quidpiam)
quisquam	     quicquam (quidquam)
quisque	     quaeque, quidque, quicque or quodque
quisquis	     quidquid (quicquid)
quiuis1	     quaeuīs, quoduīs
quiuis2	     quaeuīs, quiduīs
quiuiscumque	     quaeuīscumque, quoduīscumque
quocumque	     quōquomque
quotuscumque	     quotacumque, quotumcumque
rauistellus	           var. for grāuastellus in 
reapse	          rēabse
recino	             (intr.)
recordor	             (intr.)
refero	     ~rre, rettulī, relātum
refert	     ~rre, rētulit
reflecto	             (intr.)
remitto	             (intr.)
reor	     rērī, ratus
reparco	     ~ere, repersi
repello	     ~ere, reppulī, repulsum
repeto	             (intr.)
res	     reī
res publica	     reī publicae
resideo	     ~ēre, resēdī (resessum)
resido	     ~ere, resēdī (resīdī)
retardo	             (intr.)
retero	     ~ere, retrīuī, retrītum
retineo	             (intr.)
retracto	             (intr.)
retro	        (and 
retundo	     ~ere, rettudī (retudī), retūsum, retunsum
reuiuesco	     ~escere, reuixī, reuictum
rex1	     rēgis
rhus	     rhūs
rimor	             (?intr.)
ringor	     ~ī, (rictus)
ros	             (neut.)
roto	             (intr.)
rotula	           Apparently also 
rubellio	     -ōnis
rumo	       archaic equivalent of rūminō.
rumpo	     rumpere, rūpī, ruptum
rus	     rūris
sal	     salis
sandaserion	                of sandarēsos.
saucunculus	           dub. word in Petronius: see also sangunculus.
scabo	     ~ere, scābī
scalae	           Rarely sg. 
scindo	     ~ere, scicidī or scidī, scissum
scirpiculus2	               surp-
scopae	           Rarely sg. 
scora	           cj. 
scordastus	           (? or 
scribo	             (intr.)
scriptito	             (intr.)
scultimidoni	   (genitive?) 
scyzinum	           a (probably corrupt) name for some herbal wine.
secundus1	     ~a, ~um; comparative, superlative (in senses 1-4) ~ior, ~issimus
secus2	               sequius.
sedeo	     ~ēre, sēdī, sessum
sedo	             (intr.)
senex	     ~is, senior
seps	     sēpos
septentriones	            Subsequently sg. form 
sequo	   (apparently false deduction by Gellius from 
sequor	             (intr.)
sero1	     ~ere, sēuī, satum
serraculum	           (dub. word in Ulpian, explained by glossator as 'steering oar'.).
sesqui	          prefix
sexus	             (neut.)
sicco	             (intr.)
significo	             (intr.)
sillybus	             (?f.)
simpuuium	            var. of simpulum.
simulo	             (intr.)
sinapi	     senāpe
sino	     sinere, sīuī (siī), situm
sinuo	             (intr.)
sisto	     ~ere, stetī or stitī, statum
sium	     siī
sol	     sōlis
sopitio	   probably f.l. for sōpiō2.
spattaro	     (? ~ōnis
specus	                 (neut.)
sperno	     ~ere, sprēuī, sprētum
spero	             (intr.)
spondeo	     ~dēre, spopondī (spep-) ~sum
st	        (interjection enjoining silence) Hush! sh!
sterno	     ~ere, strāuī, strātum
steroma	        (apparently) = Greek στρω̑μα, a pavement.
stilus	           Sometimes (erroneously associated with Greek στυ̑λος) written 
stips1	     stipis
sto	     stāre, stetī, statum
stratiotis	           (or? 
subalapa	           editorial var. for subalapō.
subfarcino	   see also suffarcinō etc.
subgero	   see also suggerō etc.
subnascor	     ~ī, subnātus
subparus	   see also supparus etc.
subsum	     ~esse, suffuī
subtus	          (prep.)
suffercitus	        dub. reading in 
suffero	     ~rre, sustulī, sublātum
suffusculus	   see also subfusculus etc.
sum1	     esse, fuī
suo	     suere, suī, sūtum
supergredior	             (intr.)
supero	             (intr.)
suppeto	             (?tr.)
sus1	     suis
sus2	     sa, sum
suspicio1	             (intr.)
susque deque	   (?  susque et dēque
sustineo	             (intr.)
sustollo	     ~ere (sustulī) (sublātum)
tamarice	           tamarix.
tango	     ~ere, tetigī, tactum
temero	             (intr.)
temperi	     temperius
teneo	             (intr.)
terni	           Rarely sg. 
tero	     ~ere, trīuī, trītum
testor	             (intr.)
thiasitas	     (? ~ātis
todillus	           (apparently adjective from todī).
tollo	     ~ere, sustulī, sublātum
tracto	             (intr.)
traho	             (intr.)
traicio	             (intr.)
transporto	             (intr.)
traulizi	        Transliteration of Greek τραυλίζει 'mispronounces', 'lisps', or similar.
tres	     trēs, tria
tribuo	             (intr.)
tueor	     ~ērī, tuitus (tūtus)
tulat	   =   ferat
turgeo	     ~ēre, tursī
tus	     tūris
uado	     ~ere (uāsī)
ualuae	           Rarely sg. 
uaporo	             (intr.)
uariego	             (intr.)
uas1	     uadis
uas2	     uāsis
ubertumbis	        (unknown word in inscription from Lusitania, apparently describing deposits of ore, or similar).
uecors	     uēcordis, ~uēcordissimus
ueha	           apparently rustic form or pronunciation of uia.
uelabrum2	           word apparently treated by Festus as synonym of 
uello	     ~ere, ~ī or uulsī (uolsī), uulsum (uolsum)
uenio	     uenīre, uēnī, uentum
uerro	     ~ere, uersum (uorsum)
uerto	             (intr.)
uestio	             (intr.)
uibex	   (or 
uictrix	             (neut. adj.)
uideo	     uidēre, uīdī, uīsum
uinco	     ~ere, uīcī, uictum
uindiciae	           Rarely sg. 
uindico	             (intr.)
uir	     uirī
uis	     uis
uito	             (intr.)
ullaber	   (dub. word in augural formula).
ulterius	        (and 
ultrix	             (neut. adj.)
uolo1	     uelle, uoluī
uoueo	     ~uēre, uōuī, uōtum
uox	     uōcis
urgeo	     ~ēre, ursī
uro	     ~ere, ussī, ustum
usque	        (and 
uter1	     utris
uter3	     utra, utrum
utercumque	     utracumque, utrumcumque
uterlibet	     utralibet, utrumlibet
uterque	     utraque, utrumque
uteruis	     utrauīs, utrumuīs
utor	     ~ī, ūsus
zopyris	   (quoted by Quintilian to exemplify words beginning with z; perhaps transliteration from Greek ζa4 πυρον 'spark').
