(h)ari-	harusp		haruspex
(h)ib-	hybri		hybrida
-a	s	es=a,as=a,is=ia,us=a	canities, Carmentis, choraules, Pelias, planities, sophistes, Atrides
-a	e	ae=e,e=a,oe=a	Circe, cunae, Dione, elate, Ephyre, Erigone, facetiae, gnomonice, Grauiscae, Hecate, Hermione, heroine, Iugulae, Messene, Omphale, oporothece, oxymyrsine, Panope, Penelope, Phoenice, Pirene, Priene, Salonae, Scythice, Semele, Sinope, Taygete, Temese, Antemnae, Aphidnae, Ariane, Arsinoe
-a	n	-2	Dindymon
-a	a	ia=a,a=a	Patara, Argia
-aa	ae		Pasiphae
-acium	aceus		mustaceus
-aclum	culum	-5	gubernaculum
-ae	ia		Cutilia
-ae	sa	-1	Pagasa
-aea	hea	-2	Amalthea
-aeum	geum	-3	hypogeum
-aicus	aecus		Callaecus
-ana	ena		Athena
-ans	mas	-2	adamas
-apsis	opsis	-3	paropsis
-ar(i)arius	pecularius	--3	specularius
-aria	rius		brattiarius
-arpo	erpo		praecerpo
-as	ca	-1	Proca
-as	pa	-1	Agrippa
-asco	esco		teneresco
-ascor	pasco	-4	depasco
-asis	psis	-3	paropsis
-asius	aseus		Halicarnaseus
-assius	naseus	-4	Halicarnaseus
-assius	nasius	-4	Parnasius
-assus	nasus	-4	Halicarnasus
-atis	enas	-2	Capenas
-beia	baia		ambubaia
-ber	ris	-4	insalubris
-beus	aeus		scarabaeus
-bris	eber	-3	celeber
-byblos	biblos		monobiblos
-cha	uca	-2	carruca
-chralis	lcralis	--1	sepulcralis
-chretum	lcretum	--1	sepulcretum
-chrum	lcrum	--1	sepulcrum
-chuma	achma	--1	drachma
-cium	acia	-2	armoracia
-cius	ceus		hordeaceus
-cius	ctus		aulicoctus
-cla	ula	-4	securicula
-clum	ulum	+1	spectaculum, tomaculum, umbraculum
-co	uo	-3	discoquo
-cor	sco	-2	pasco
-cre	rum	-4	inuolucrum
-ctho- -cto-	.	ntichthones		antichthones
-cto	tor	-4	amplector
-culus	culum		perpendiculum
-cunque	cumque		quacumque, qualiscumque, quandocumque, quicumque, quotienscumque, quantuscumque
-cuo	ueo	-4	ablaqueo
-cus	uus	-4	obliquus, pedisequus
-cus	ius	-3	Anactorius
-cō	uo	-3	discoquo
-datios	dateus		Mithridateus
-datius	dateus		Mithridateus
-decumani	decimani		quartadecimani
-decumanus	decimanus		quintadecimanus
-dianus	edanus	--1	subaedanus
-dibilis	sibilis		comprehensibilis
-dinarius	denarius		cuppedenarius
-drea	drya		melandrya
-dros	nder	--1	Menander
-drus	nder	--1	Maeander, Anaximander
-e	l	-2	capital
-e	a		Clytia, Dodona, Eriphyla, Europa, exagoga, geometrica, grammatica, Helena, Hersilia, Hesiona, Hippolyta, Ida, Iliona, Laconica, Leda, Leucata, Libya, mathematica, Melita, musica, parabola, Pella, phoca, Phthia, pinacotheca, poetica, Polyxena, Prochyta, Samothraca, Sparta, stacta, stela, symbola, Urania, Aeaea, Aetna, amygdala, Ariadna, arithmetica, Atalanta, Hippodamia, pyrricha, schola, Hypermestra
-e	i		procliui
-ea	ia		fascia, Galatia, Seleucia, spongia, adoria, Antiochia
-ebes	lebs	--1	plebs
-ee	ea		Leucothea
-eius	geus	--1	Sigeus, Argeus
-ela	lla	+1	obsequella
-elis	ilon		onochilon
-ellum	illum		scabillum
-ellus	illus		codicillus
-en	io		Anio
-enius	inius		faecinius
-enses	esses		decatresses
-ensimus	gesimus	--1	nonagesimus, quinquagesimus
-ensimus	tesimus	--1	nongentesimus
-ensius	nesius	--1	Proconnesius
-ensus	nesos	--1	Proconnesos
-ensus	nesus	--1	Peloponnesus
-enus	inus		Dyrrhachinus
-eo	io		deascio
-eo	do	-1	frendo, instrido
-eo	or	-3	polliceor
-eola	iola		fasciola, maceriola
-eor	reo	-2	demereo, emereo, promereo
-eor	ceo	-2	excalceo
-eos	eus		Alpheus
-eris	aris		phalaris
-erosus	orosus		facinorosus
-es	ae		druidae
-es	ia		duritia, maceria, materia, militia, mollitia, munditia, notitia, pigritia, segnitia, spurcitia, tristitia
-es	ni	-1	Edoni
-es	la	-1	hydraula
-es	ta	-1	Nabata
-es	as		Pantagias
-es	ex		ramex
-es	ci	-1	Triboci
-es	is		Aeolis
-es	es		Apelles
-es	ea		Tegea
-es	us		Uologesus
-esco	isco		delitisco
-esis	nsis		Peloponnensis
-essus	besus	--1	obesus
-estor	mesor	--1	comesor
-eteus	iteus		Polycliteus
-eticus	iticus		purpuriticus
-etius	iteus		Polycliteus
-etus	itus		Polyclitus
-eum	ium		glaucium
-eum	ion		psyllion
-eus	eus		Daedaleus, Atalantaeus, Cydonaeus
-eus	ius		pellicius, Pittheius, precarius, Taenarius, ambrosius, Aristotelius, aerius, aetherius, Antiochius
-eus	les		Achilles
-eē	ea		Leucothea
-eō	do	-1	frendo, instrido
-eō	or	-3	polliceor
zzz
-fascine	fiscini		praefiscini
-forus	horus		pastophorus
-frango	fringo		diffringo
-giae	egae		Aegae
-glesco	glisco		reglisco
-gni- -gine-	abiegnus		abiegnus
-go	eo		detergeo, extergeo
-guo	ngo		tingo
-gō	eo		extergeo
-i	s		Tingis
-ia	ea		Chaeronea, Dicaearchea, tinea, Anticlea, collactea, Achillea
-ia	ia		Paroreia
-ia	ra		uniuira
-iae	eae		sculponeae
-iatus	eatus		excalceatus
-ici	qui		antiqui
-ictor	nctor		pollinctor
-icula	ecula		trabecula
-ideo	edeo		supersedeo
-ideō	edeo		supersedeo
-ienses	nenses		Tarracinenses
-iensis	eensis		Heracleensis
-iensis	pensis		Philippensis
-iensis	nensis		Mediolanensis
-ies	ens		aliquotiens, octingentiens, quindeciens, quingentiens, pauciens, quadragiens, quinquagiens, septiens
-ietum	netum		castanetum
-ii	ei		Aristarchei
-ilatim	llatim		frustillatim
-illus	ellus		porcellus
-in	is		Salamis
-inio	lino		circumlino, oblino
-inisco	niscor		comminiscor
-iniscō	niscor		comminiscor
-iniō	lino		circumlino, oblino
-innum	inium		conticinium
-inpono	impono		superimpono
-io	or		blandior, demolior, molior, sortior, adorior
-io	pi		coepi
-io	eo		percieo
-io	io		sororio
-iolus	eolus		phaseolus, argenteolus
-ion	ium		smyrnium, Aegium, cycnium, daemonium, anthyllium, apodyterium
-ion	eum		cichoreum
-ion	ius		Iasius, Icadius
-ior	rio		comperio, nutrio
-ior	cio		nancio
-ior	tio		partio
-ior	nio		somnio
-ios	eus		Spercheus, Peneus
-is	er		acipenser
-is	ys		Capys, pelamys
-is	us		effrenus, hilarus, inanimus, limus, multiforus, multiiugus, opiparus, quadriiugus, semisomnus, Anapus, unanimus
-is	on		Sason
-is	is		tigris
-isco	esco		uetustesco, insenesco
-iscō	esco		insenesco
-isso	rizo		gargarizo
-itius	icius		nutricius
-ium	eum		gynaeceum, centaureum, euphorbeum, adoreum, alcyoneum, Amaltheum
-ium	num		sterculinum
-ium	lum		amphimallum
-ium	ion		batrachion, dracontion
-ius	ter		affluenter
-ius	eus		Pythagoreus, triticeus, arboreus, Carneadeus, Cauneus, corticeus, Democriteus, Diomedeus, farraceus, Homereus, Lyrceus, pannuceus, uinaceus, spondeus, Hermioneus
-ius	ris		tolutaris
-ius	rus		bucerus
-ius	mus		hippopotamus
-iēs	ens		pauciens, quadragiens, septiens
-iō	or		blandior, demolior, molior, sortior, adorior
-iō	pi		coepi
-iō	eo		percieo
-iō	io		sororio
-iōn	ius		Iasius, Icadius
-leos	laus		Philolaus
-litus	ithus		monolithus
-llaca	ilaca		porcilaca
-locus	oquus		grandiloquus, magniloquus
-lubet	libet		quilibet, quilibet, qualibet
-meitus	amitus		Catamitus
-moeroe	imurus		Aegimurus
-n	i		alioqui
-n	o		Croto, Croto, croto, Laco, phago, Plato, Polemo, Rubico, Tarraco
-n	s		delphinus
-naris	iaris		tricliniaris
-ne	ni		praefiscini
-nensis	iensis		Statoniensis
-nensus	onesus		Cherronesus
-nessus	onesus		Cherronesus
-neus	aeus		Ariadnaeus
-nio	neo		delineo
-ns	as		praegnas
-num	ium		Tauromenium
-nus	eus		populneus
-nus	tan		Titan
-o	r		criminor, cohortor, conuiuor, cunctor, depeculor, depopulor, euagor, exhortor, expergiscor, frustror, imaginor, imitor, insector, insidior, luctor, ludificor, minitor, miseror, moderor, morigeror, moror, mutuor, opitulor, osculor, peruagor, populor, praestolor, proelior, recordor, refragor, reluctor, remuneror, sciscitor, sermonor, suffragor, suspicor, tumultuor, uelitor, ueneror, uociferor, urinor, adueneror, auspicor, auxilior, sauior, percontor
-o	s		Dercetis, silus
-o	o		suboleo
-odium	onium		septizonium
-oe	pi		Arimaspi
-ola	ula		cellula
-olentus	ulentus		pisculentus
-olus	ulus		cliuulus, inuoluulus
-on	um		cinnamum, Sigeum, archetypum, arum
-on	os		Androgeos
-on	to		Aristo
-ona	ana		cottana
-ona	nia		Populonia
-ones	ryon		Geryon
-onēs	ryon		Geryon
-ope	pia		Cassiepia
-opea	epia		Cassiepia
-or	to		oscito, bubulcito, delecto, hieto, molesto, quirito, ructo, adiuto
-or	ro		belligero, commurmuro, elucubro, honoro, munero, murmuro, pigro, admurmuro, auguro
-or	lo		bello, latibulo, pugillo
-or	co		commanduco, fabrico, fatisco, frutico, glisco, labasco, manduco, mendico, nutrico, proco, sacrifico, albico
-or	io		conglacio, luxurio, radio, spolio
-or	no		digno, hiberno, rumino, uermino
-or	po		expalpo, participo
-or	uo		fluctuo
-or	go		indago, aurigo
-or	or		intueor
-oris	ecor		indecor
-oro	ero		pignero
-os	us		choreus, Halicarnasus, Heracleus, amethystus, acephalus, Bithynus, cammarus, catalecticus, chrysocarpus, clymenus, cyanus, Cyprus, dactylus, hendecasyllabus, heroicus, horaeus, hyoscyamus, isodomus, miurus, Molossus, monaulus, monogrammus, Naxus, obolus, Oxus, paliurus, paralius, physicus, Polyphemus, sophisticus, trimetrus, Achelous, adoptiuus, Aeacus, Anacreontius, Aspendius, atauus, atomus, Atticus, autopyrus, iambus, Ionicus
-ossis	exos		exos
-ous	hus		Panthus
-parabilis	perabilis		aequiperabilis
-paro	pero		aequipero
-partito	pertito		quadripertito
-parābilis	perabilis		aequiperabilis
-pertum	partum		antepartum
-plector	mplecto		circumplecto
-plusio	plosio		supplosio
-purigo	rpurgo		perpurgo
-quinus	rcinus		hircinus
-quod	quot		aliquot
-quomque	icumque		quicumque
-quonque	scumque		quotienscumque
-quos	quus		obliquus
-quus	rcus		hircus
-sideo	sedeo		circumsedeo
-sillus	xillus		pauxillus
-sio	tio		intentio
-so	uo		exdorsuo
-spargo	spergo		circumspergo
-tae	tes		Aegates
-taria	teria		Pandateria
-taria	iaria		ratiaria
-tarius	iarius		ratiarius
-tensimus	ntesimus		quadringentesimus
-ter	ter		sequester
-tia	tea		Necyomantea
-tor	rto		praeuerto
-truo	ryon		Amphitryon
-uclus	culus		pediculus
-uculus	iculus		pediculus, anniculus
-uersum	uersus		quoquouersus
-ulter	liter		difficiliter
-um	on		chalcanthon
-um	us		quoqueuersus, retrouersus
-um	te		Tergeste
-um	ta		armamenta
-umus	imus		septimus
-uorsum	uersus		quoquouersus
-us	um		costum, deorsum, dextrorsum, Misenum, aeuum
-us	lu		gelu
-us	is		bisulcis, cannabis, elumbis, eneruis, exanimis, glanis, inermis, infrenis, interpolis, procliuis, sublimis, torris, forctis
-us	ur		camur
-us	os		cissanthemos, Otos, acrolithos, Arctos, Atheos
-us	iu		diu
-us	nu		genu
-us	us		Numicius, Oedipus, pinus
-us	uo		pauo
-uza	ssa		obrussa
-yr	ur		Astur
-ys	us		Phorcus
-ā	a		Argia
-āna	ena		Athena
-ātis	enas		Capenas
-ē	a		Clytia, Dodona, Eriphyla, Europa, exagoga, geometrica, grammatica, Helena, Hersilia, Hesiona, Hippolyta, Ida, Iliona, Laconica, Leda, Leucata, Libya, mathematica, Melita, musica, parabola, Pella, phoca, Phthia, pinacotheca, poetica, Polyxena, Prochyta, Samothraca, Sparta, stacta, stela, symbola, Urania, Aeaea, Aetna, amygdala, Ariadna, arithmetica, Atalanta, Hippodamia, pyrricha, schola, Hypermestra
-ēa	ia		Seleucia, Antiochia
-ēbēs	lebs		plebs
-ēn	io		Anio
-ēos	eus		Alpheus
-ēs	ae		druidae
-ēs	ia		duritia, maceria, materia, militia, mollitia, munditia, notitia, pigritia, segnitia, spurcitia, tristitia
-ēs	ni		Edoni
-ēs	la		hydraula
-ēs	ta		Nabata
-ēs	as		Pantagias
-ēs	ci		Triboci
-ēs	is		Aeolis
-ēs	es		Apelles
-ēs	ea		Tegea
-ēs	us		Uologesus
-ēum	ium		glaucium
-ēus	eus		Cydonaeus
-ēus	ius		Antiochius
-īa	ea		Achillea
-īn	is		Salamis
-īos	eus		Peneus
-īum	eum		alcyoneum, Amaltheum
-īus	eus		Carneadeus, Democriteus, Diomedeus, Homereus, Lyrceus, spondeus
-īī	ei		Aristarchei
-ō	r		cohortor, conuiuor, cunctor, depeculor, depopulor, euagor, exhortor, frustror, imaginor, insector, insidior, luctor, ludificor, minitor, miseror, moderor, morigeror, moror, mutuor, opitulor, osculor, peruagor, populor, praestolor, proelior, recordor, refragor, reluctor, remuneror, sciscitor, sermonor, suffragor, suspicor, tumultuor, uelitor, ueneror, uociferor, urinor, auspicor, auxilior, sauior, percontor
-ō	s		Dercetis, silus
-ō	o		suboleo
-ōn	os		Androgeos
-ūs	iu		diu
Acch-	Ache		Acheruns, Acherunticus, Acherusius
Adr-	Had		Hadria, Hadrianus, Hadriaticus
Aefl-	Aefu		Aefulanus
Agr-	Acr		Acragantinus, Acragas
Agragant-	Agrigent		Agrigentini
Aim-	Aem		Aemilianus, Aemilius
Amunc-	Amync		Amynclanus
Amycl-	Amync		Amynclae
App-	Ape		Apenninicola, Apenninigena, Apenninus, Apenninus
App-	Apu		Apulia, Apulus
Ario-	Areo		Areopagites
Athl-	Atla		Atlanticus
Att-	Acc		Accius
Auel-	Abel		Abellanus
Bale-	Bali		Baliaricus, Baliaris
Bebr-	Bedr		Bedriacus
Beron-	Beren		Berenice
Betr-	Bedr		Bedriacensis, Bedriacum
Bub-	Byb		Byblos
Caele-	Caeli		Caelimontanus
Caer-	Cere		Cerealicius, Cerealis
Calid-	Calyd		Calydonius
Camal-	Camul		Camulodunum
Caphar-	Capher		Caphereus, Caphereus
Capra-	Capro		Caprotina
Cass-	Casi		Casinas
Ceri-	Cere		Cerealis
Ceu-	Ceb		Cebenna
Chalc-	Calch		Calchedonensis
Cibu-	Ciby		Cibyrates
Clu-	Clo		Cloacina
Cocul-	Cocle		Cocles
Compet-	Compit		Compitalis
Conl-	Coll		Collatia
Conp-	Comp		Compitalia, Compitalicius, Compitalis
Conseu-	Consiu		Consiuius
Culm-	Colm		Colminius
Cup-	Cyp		Cyprigenia
Curr-	Curi		Curitis
Cygn-	Cycn		Cycneis
Cyp-	Cip		Ciprius
Delm-	Dalm		Dalmatia, Dalmaticus
Diuit-	Diuic		Diuiciacus
Duel-	Duil		Duillius
Duell-	Bello		Bellona
Durra-	Dyrrh		Dyrrhachinus, Dyrrhachium
Ericth-	Ericht		Erichthonius, Erichthonius
Euhad-	Euadn		Euadne
Fac-	Fag		Fagutalis
Fac-	Pha		Phacelinus
Far-	Pha		Phariacus
Ferent-	Frenta		Frentani
Ficol-	Ficul		Ficulensis
Fil-	Phi		Philippus
Fin-	Phi		Phineius
For-	Fur		Furrina
Furn-	Forn		Fornacalia
Gall-	Call		Callaecia, Callaecus
Genu-	Ceno		Cenomani
Germ-	Cerm		Cermalensis, Cermalus
Get-	Gae		Gaetulus
Gn-	Cn		Cnidos
Haed-	Aedu		Aedui
Hale-	Hala		Halaesus
Hil(l)ur-	Illyricu		Illyricus
Hil-	Ill		Illyricum
Hord-	Ford		Fordicidia
Iapu-	Iapy		Iapydes, Iapydia
Iazu-	Iazy		Iazyges
Idy-	Idu		Idumaeus, Idume
Ipp-	Hip		Hippolytus
Irp-	Hir		Hirpinus
Ityr-	Itur		Ituraei, Ituraeus
Kar-	Car		Carthaginiensis, Carthago
Lacet-	Laeet		Laeetania, Laeetanus
Lalet-	Laeet		Laeetania, Laeetanus
Lat-	Let		Letois, Letoius, Letous
Lau-	Lab		Labicanus
Lau-	Lao		Laodicensis, Laodicenus, Laomedon, Laomedonteus
Leuc-	Luce		Lucetius
Lub-	Lib		Libentina
Luc-	Loc		Locusta
Lugd-	Lugu		Lugudunum
Lyc-	Luc		Lucomedius
Marsu-	Marsy		Marsyas
Matt-	Mati		Matius
Menenn-	Meneni		Menenius
Ment-	Mint		Minturnae, Minturnensis
Mityl-	Mytil		Mytilenaeus, Mytilenensis
Mosall-	Mosell		Mosellicus
Nabath-	Nabata		Nabataeus
Odiss-	Odyss		Odyssea
Ouf-	Ufe		Ufens, Ufentinus
Pal-	Pal		Palatinus, Palatium
Panorm-	Panhor		Panhormitanus
Pel-	Pae		Paeligni, Paelignus
Plot-	Plau		Plautius
Popl-	Publ		Publicola
Populi-	Poplif		Poplifugia
Ramn-	Rham		Rhamnusius
Rham-	Ramn		Ramnes
Rheg-	Regi		Reginus, Regium
Rhi-	Rip		Ripaeus
Rod-	Rau		Raudusculana
Rod-	Rho		Rhodiensis, Rhodius, Rhodus
Romul-	Romil		Romilius
Rud-	Rau		Raudusculana
Sam-	Sem		Semiramis
Sar-	Ser		Serapio, Serapis
Saur-	Sora		Soracte
Sic-	Sug		Sugamber
Sig-	Sug		Sugamber
Sipunt-	Sipont		Sipontinus
Sisp-	Sosp		Sospita
Summ-	Subm		Submemmianus
Syc-	Sug		Sugamber
Syg-	Sug		Sugamber
Tam-	Tom		Tomyris
Ter-	Tir		Tiresias
Thal-	Tala		Talassius
Tham-	Tomy		Tomyris
Theo-	Thei		Theiodamas
Thio-	Thei		Theiodamas
Threc-	Thrae		Thraecidicus
Toloss-	Tolosa		Tolosanus
Treuir-	Treuer		Treuericus
Trogl-	Trogo		Trogodytae, Trogodyticus, Trogodytis
Virdu-	Uirid		Uiridomarus
Vlis-	Olis		Olisipo
Xers-	Xerx		Xerxes
abb-	adb		adbibo
abf-	afl		afluo
abs-	aps		apsinthites, apsinthium, apsinthius
accers-	arcess		arcessitor, arcessitus
acu-	aqu		aquarius
acula aquu-	aquola		aquola
ad(g)n-	agnosc		agnosco
ad-	ac		accedo
adc-	acc		accommodate, accumulate, accurate, acceleratio, accelero, accessio, accessus, acclamatio, acclamo, acclaro, acclinis, acclino, accliuis, accliuitas, accognosco, accola, accolo, accommodatio, accommodatus, accommodo, accommodus, accredo, accresco, accretio, accretus, accubitio, accubitus, accubo, accudo, accumbo, accumulatio, accumulator, accumulo, accuratio, accuratus, accuro, accurro, accursus
adf-	aff		affabiliter, affabre, affirmate, affluenter, affaber, affabilis, affabilitas, affamen, affatus, affectatio, affectator, affectio, affecto, affectus, affectus, affero, afficio, afficticius, affigo, affiguro, affingo, affinis, affinis, affinitas, affirmatio, affirmator, affirmo, affixa, afflatus, afflecto, affleo, afflexus, afflictatio, afflicto, afflictor, afflictrix, afflictus, afflictus, affligo, afflo, affluens, affluentia, affluo, affodio, affor, afformido, affrango, affremo, affrico, affrictus, affrio, affulgeo, affundo
adg-	agg		aggemo, aggero, aggestus, agglomero, agglutino, aggrauesco, aggrauo, aggredior, aggrego, aggressio, aggressor, aggressura, aggressus, agguberno
adgn-	agna		agnata, agnatio, agnatum, agnatus
adgn-	agni		agnitus
adgn-	agno		agnomen, agnomentum
adl-	all		allabor, allaboro, allacrimo, allambo, allapsus, allatro, allaudabilis, allaudo, allauo, allectatio, allecto, allector, allegatio, allegatus, allego, allego, alleuamentum, alleuatio, alleuo, alleuo, allicefacio, allicio, allido, alligatio, alligator, alligatura, alligo, allino, alliuesco, allocutio, alloquium, alloquor, allubentia, alluceo, alluctor, alludio, alludo, alluo, alluuies, alluuio
adol-	adul		adulescens, adulescentia
adp-	app		apparate, appetenter, apposite, apprime, approbe, apparatio, apparator, apparatorium, apparatus, apparatus, apparens, appareo, appario, apparitio, apparo, appello, appello, appendo, appetens, appetentia, appetibilis, appetisso, appetitio, appetitus, appeto, appiciscor, appingo, applausus, applicatio, applicatus, applicitus, applico, apploro, applumbator, applumbo, appono, apporrectus, apportatio, apporto, appositus, appotus, apprecor, apprehendo, apprenso, apprimo, apprimus, approbatio, approbator, approbo, approbus, appromissor, appromitto, approno, appropero, appropinquatio, appropinquo, appugno, appulsus
adp- applodo	app		applaudo
adq-	acq		acquiesco, acquiro, acquisitio, acquisitrix, acquisitus
adr-	arr		arrepo, arrideo, arrigo, arripio, arrisio, arrisor, arrodo, arrogans, arroganter, arrogantia, arrogatio, arrogator, arrogo, arrosor, arruo
ads-	ass		assecue, assentatorie, asseuerate, assiduo, assimiliter, assimulanter, assudesco, assultim, assectatio, assectator, assector, assensio, assensor, assensus, assentatio, assentatiuncula, assentator, assentio, assentior, assentor, assequor, assero, assero, assertio, assertor, asseruio, asseruo, assessio, assessor, assessura, assestrix, asseueranter, asseueratio, asseuero, assibilo, assiccesco, assicco, assideo, assido, assidue, assiduitas, assiduus, assignatio, assignator, assignifico, assigno, assilio, assimilis, assimulatio, assipio, assisto, assitus, associo, assoleo, assono, assubrigo, assuefacio, assuesco, assuetudo, assuetus, assugo, assulto, assultus, assumo, assumptio, assumptiuus, assuo, assurgo, assuscipio, assuspiro
ads-	asc		ascensus, ascio, ascisco, ascribo, ascripticius, ascriptio, ascriptiuus, ascriptor
ads-	asp		aspectus, aspicio, aspiramen, aspiratio, aspuo
ads-	ast		astator, asterno, astipulatio, astipulator, astipulatus, astipulor, astituo, asto, astrepo, astricte, astrictio, astrictorius, astrictus, astringo, astruo, astupeo
ads- assecla	ass		assecula
adsc-	asce		ascendo
adt-	att		attemperate, atterraneus, attactus, attempero, attendo, attente, attentus, attenuatio, attenuo, attero, attestatio, attestatus, attestor, attexo, attibernalis, attineo, attingo, attollo, attondeo, attonitus, attono, attorqueo, attractus, attraho, attrectatio, attremo, attrepido, attribuo, attributio, attritus, attritus, attumulo, attuor
adt- attento	att		attempto
adt- attracto	att		attrecto
aduerto -uorto	angu		animaduerto
adul-	adol		adolesco
aduor-	aduer		aduerto
aduors-	aduers		aduersabilis, aduersarius, aduersarius, aduersatrix, aduersitor, aduerso, aduersor, aduersum
aestu-	aesti		aestimatio
agn-	acn		acnua
ahen-	aene		aeneum, aeneus
all-	ali		alium
alum-	alim		alimentarius, alimentum
amf-	anf		anfractus
amm-	adm		adminiculum, administer, administro, admiror, admoneo, admoueo
anet-	anat		anaticula, anatinus
angl-	angu		angulatus
angol-	angul		angularius
ann-	adn		adnato, adnitor, adno, adnumero, adnuntio, adnuo
anti-	ante		antegerio, antecessus, antesto
anticus -cuus	qui		antiquus
antil-	antel		antelucanus
apoca-	apoch		apochatus
aps-	abs		absque, absurde, absum, abscedo, abscido, abscondo, absens, absentia, absoluo, absonus, absorbeo, absterreo, abstineo, absto, abstraho, abstrudo, abstrusus, absumedo
arct-	arto		arto
arcu-	arqu		arquatus
argi-	arge		argemonia
arqu-	arcu		arcuatura, arcuatus
arqui-	arcip		arcipotens
arqui-	arcit		arcitenens
arre-	haru		haruspex
arre-	arrh		arrhenicum
aru-	adu		adueho
aspargo ads-	aspergo		aspergo, aspergo
assimilo ads-	assimulo		assimulo
astrideo ads-	astrido		astrido
auct-	autu		autumnitas
aure-	auri		aurificina
baio-	baiu		baiulus
balin-	balne		balnearius, balneator, balneum
benif-	benef		beneficium, beneficus
beniu-	beneu		beneuole, beneuolens, beneuolentia, beneuolus
berul-	beryl		beryllus
bess-	besa		besalis
blatt-	blate		blatero
bybl-	bibl		bibliopola, bibliotheca
caet-	cete		ceterus
cal-	gal		galbeus
cal-	kal		kalendae, kalendarium
calci-	calce		calceamentum, calcearium, calcearius, calceator, calceatus, calceo
cald-	cali		calidarius
calic-	calyc		calyculus
calien-	calian		caliandrum
capri-	capre		capreolus
care-	cary		caryota
cari-	cary		caryota
carnu-	carni		carnificina, carnificius
cataph-	catafr		catafractarius, catafractus, catafractes
cem-	cae		caementicius, caementum
cer-	ger		gerro
cerc-	circ		circius
chir-	cher		cheragra, cheragricus
chort-	cohor		cohortalis
circun-	circum		circumdo
clam-	chla		chlamys
clathr-	clatra		clatratus
clod-	clau		claudigo
clos-	clau		claustellum, claustrarius, claustrum
clup-	clip		clipeatus, clipeo
clus-	clys		clyster
cod-	cau		caudicarius
coherc-	coerce		coerceo
coherc-	coerci		coercitio
col-	coa		coalesco
coli-	caul		cauliculus
collu-	colly		collybus
collub-	collib		collibuit
coloe-	colyp		colyphium
comaud-	coaudi		coaudio
comm-	comi		comissatio
compet-	compit		compitum
con-	com		combenno
conang-	coangu		coangusto
conb-	comb		combibo, combibo, comburo, combustum
concalf-	concale		concalefacio
concamar-	concamer		concameratio
coninq-	coinqu		coinquo
conl-	coll		collabasco, collabefacto, collabefio, collabello, collabor, collacrimatio, collacrimo, collactaneus, collacteus, collaticius, collatio, collatiuus, collator, collatro, collaudatio, collaudo, collectio, collega, collegium, colleuo, colliberta, collibertus, collibro, collibuit, colliciae, colliciaris, collido, colligatio, colligo, collimo, collino, colliquefacio, colliquesco, collisio, collisus, collisus, collocatio, colloco, collocupleto, collocutio, colloquium, colloquor, colluceo, colluco, colluctatio, colluctor, colludo, collumino, colluo, collurchinatio, collusim, collusio, collusor, collusorie, collustrium, collustro, collutio, collutulento, colluuiaris, colluuies, colluuio, collacero, collinio
conm-	comm		commemoramentum, commemoratio, commemoro, commercor, commereo, commetior, commitigo, committo, communis, communitus
conn-	cone		conecto, conexus
conn-	coni		conitor, coniueo
conp-	comp		compactus, compaganus, compages, compago, compar, comparabilis, comparate, comparatio, comparatio, comparatiue, comparatiuus, comparator, comparatus, compareo, comparo, comparo, compartior, compasco, compascuus, compastor, compatriota, compatronus, compauesco, compauio, compedio, compeditus, compellatio, compello, compello, compendiaria, compendiarium, compendiarius, compendiosus, compendium, compenso, comperco, comperendinatio, comperendinatus, comperendino, comperendinus, compernis, compertusio, compes, compesco, competens, competenter, competentia, competitor, competitrix, competo, compilatio, compilo, compilo, compingo, compitensis, complaceo, complaco, complanator, complano, complector, complementum, compleo, completus, complexio, complexiuus, complexus, complico, complodo, comploratio, comploratus, comploro, compluit, complures, compluriens, complurimi, compluscule, complusculi, compluuiatus, compluuium, compono, comportatio, comporto, compos, composite, compositicius, compositio, composito, compositor, compositum, compositus, compotatio, compotens, compotio, compoto, compotor, compotrix, compraecido, compraes, compransor, comprecatio, comprecor, comprehendo, comprehensibilis, comprehensio, comprehenso, compresse, compressio, compressor, compressus, compressus, comprimens, comprimo, comprobatio, comprobator, comprobo, compromissarius, compromissum, compromitto, compugno, compulsio, compulso, compungo, computabilis, computatio, computator, computo, computresco
conr-	corr		corrado, correctio, corrector, correctus, corregio, correpo, correpte, correptio, correptus, correus, corrideo, corrigo, corripio, corriuatio, corriuo, corroboro, corrodo, corrogo, corrotundo, corrugo, corrumpo, corruo, corrupte, corruptela, corruptio, corruptor, corruptrix, corruspor
contut-	contui		contuitus
conuor-	conuer		conuerto
cop-	cau		caupona
cop-	coo		cooperculum, cooperimentum, cooperio, cooptatio, coopto
corolit-	coralli		coralliticus
corollit-	corallit		coralliticus
cot-	cot		cottidiano, cottidie, cottidio
coti-	cott		cottidianus
crab-	grab		grabatus
crass-	grass		grassator
cum-	cym		cymatium
cupe-	cupp		cuppedia, cuppedo
cupi-	cupp		cuppedia
defrud-	defrau		defraudo
deiur-	deier		deiero
delachr-	delacri		delacrimatorius
deliq-	delic		delicuus
dem-	dam		damiurgus
dem-	dim		dimetior, dimetor
dendrof-	dendrop		dendrophorus
der-	dir		directe, directio, directo, directura, directus, dirigo
des-	dis		dissignator
deuor-	deuer		deuersor, deuersorius, deuerticulum, deuerto
dimm-	dimi		diminuo
dirr-	diru		dirumpo
disr-	diru		dirumpo
diu-	deu		deuerbium, deuersorium
dole-	doli		doliarium, doliarius
domi-	dome		domefactus
duell-	bella		bellator
duell-	belli		bellicus
dysint-	dysent		dysenteria, dysenterici
ebur-	ebor		eborarius, eboratus
ecn-	enu		enubo
ed-	he		hedera, hederaceus
ed-	ae		aedificiolum, aedilicius, aedilis
el-	he		helops, heluella
ell-	hel		helluor
emi-	hem		hemitritaeus
enl-	ell		ellychnium
epistol-	epistul		epistularis
erad-	exra		exradicitus
erung-	eryng		eryngion
esc-	aes		aesculetum, aesculus
ex(s)erc-	exsarcio		exsarcio
ex(s)ol-	exulo		exulo
exf-	eff		effluo, effodio, effrico, effugio
exint-	exent		exentero
exops-	exobs		exobsecro
exr-	era		eradico
exr-	ero		erogo
exs-	exi		exilium
exs-	exo		exolesco
exs-	exu		exulatio, exulatus, exulo
fael-	fele		feles
faet-	foet		foeteo, foetidus, foetor
famil-	famul		famulitas
farct-	fartu		fartum, fartus
fas-	pha		phaseolus
fec-	fae		faecula, faeculentus
fen-	fae		faenarius, faenebris, faeneratio, faenerator, faeneratorius, faeneratrix, faenero, faenicularius, faeniculum, faenilia, faenisex, faenisicia, faenisicium, faenum, faenus, faenusculum
feru-	ferr		ferrumen, ferruminatio, ferrumino
fet-	foe		foeteo, foetidus, foetor, foetulentus, foetutina
figil-	figli		figlinae
figul-	figli		figlinae
fist-	fest		festuca, festucatio, festuco
fore-	fori		foricula
fremeb-	fremib		fremibundus
fryg-	phry		phrygio
fundol-	fundul		fundulum
futil-	futti		futtilis, futtilitas
gar-	car		caryophyllon
gene-	geni		genista
glaeb-	gleba		gleba
glaeb-	glebo		glebosus
glaeb-	glebu		glebula
gles-	glae		glaesum
gluc-	cluc		clucidatus
glut-	glit		glittus
gn-	na		nascor, nauo
gna-	nau		nauiter
grauid-	graued		grauedinosus
grem-	crem		cremialis, cremium
gumm-	cumm		cummitio
hab-	abu		abunde
hal-	ali		alica, alicarius, alicarius, alicastrum
hal-	alu		alucinatio, alucinor
halof-	halop		halophanta
hap-	apa		apalus
hei-	eiu		eiulatus, eiulito
hel-	elu		elucus
herc-	erci		erciscor
hordi-	horde		hordeaceus, hordearius
hum-	ume		umecto, umectus
hum-	umi		umidus
iaent-	ienta		ientaculum
iai-	iei		ieiunitas
iant-	ient		ientaculum, iento
ieient-	iento		iento
ill-	ili		ilico
inadf-	inaff		inaffectatus
inb-	imb		imbalnities, imbarbesco, imbecille, imbecillitas, imbecillus, imbellia, imbellis, imberbis, imbibo, imbito, imbubino
incomprens-	incomprehe		incomprehensibilis
indep-	indip		indipiscor
infid-	infun		infundibulum
infum-	infim		infimatis
inioc-	iniuc		iniucundus
inm-	imm		immaculatus, immadesco, immanis, immanitas, immaniter, immansuetus, immature, immaturitas, immaturus, immedicabilis, immedicatus, immeditate, immeditatus, immeio, immemor, immemorabilis, immemoratus, immemoria, immensitas, immensum, immensum, immensus, immeo, immerens, immerenter, immergo, immerito, immeritus, immersabilis, immetatus, immetuens, immigro, imminuo, imminutio, imminutus, immisceo, immiserabilis, immisericorditer, immisericors, immissarium, immissio, immitis, immitto, immixtus, immobilis, immoderate, immoderatio, immoderatus, immodeste, immodestia, immodestus, immodice, immodicus, immodulatus, immolatio, immolator, immolitus, immolo, immorior, immoror, immortalis, immortalitas, immortaliter, immortalitus, immotus, immoueo, immugio, immulgeo, immunditia, immundus, immunio, immunitas, immunitus, immurmuro, immusulus, immutabilis, immutabilis, immutabilitas, immutabiliter, immutatio, immutatus, immutesco, immutilatus, immuto
inr-	irr		irrado, irrasus, irrationabilis, irreligatus, irreligiose, irreligiosus, irremeabilis, irremediabilis, irremunerabilis, irreparabilis, irrepertus, irrepo, irreposcibilis, irreprehensus, irrepto, irrequiebilis, irrequietus, irresectus, irresolubilis, irresolutus, irrestinctus, irretio, irretortus, irretusus, irreuerens, irreuerenter, irreuerentia, irreuocabilis, irreuocatus, irridenter, irrideo, irridicule, irridiculum, irridiculus, irrigatio, irrigiuus, irrigo, irriguus, irrisio, irrisor, irrisus, irritabilis, irritabilitas, irritamen, irritamentum, irritatio, irritator, irritatus, irrito, irritus, irroborasco, irroboro, irrogatio, irrogo, irroro, irrubesco, irructo, irrugo, irrumabiliter, irrumator, irrumo, irrumpo, irruo, irruptio, irruptus, irraucesco
insap-	insip		insipiens
insup-	insub		insubtilis, insubtiliter
int-	ind		indusiatus, indusium
intellig-	intelleg		intellegentia
interkal-	intercal		intercalaris
inuol-	inuul		inuulnerabilis
ioc-	iec		iecusculum
ioc-	iuc		iucunditas, iucundus
ir-	hi		hirundo
irq-	hir		hirquitallus
isci-	isch		ischiacus
kal-	cal		calumnia
kan-	can		canabae, candidatus, candidatus
kap-	cap		capitularium
kata-	cata		catafractarius
lagun-	lagon		lagonarius
linia-	linea		lineamentum
liter-	litte		litterula
lub-	lib		libenter, libentia, libidinitas, libidinose, libidinosus, libido
luc-	loc		locusta
lunt-	lint		lintriculus
lynt-	lint		lintrarius
macch-	macha		machaera
maii-	maie		maiestus
malif-	malef		maleficus
maliu-	maleu		maleuolentia, maleuolus
mammi-	mamme		mammeatus
mancup-	mancip		mancipatio
mani-	manu		manubrium
manipl-	manipu		manipularis, manipularis
manupl-	manipu		manipularis, manipularius
matru-	matri		matrimonium
mel-	mel		mellina
meli-	medi		medipontus
men-	mae		maenianum
metic-	metuc		metuculosus
mil-	smi		smilax
mill-	mili		miliarium, miliarius, miliens
moet-	muti		mutinus
molt-	mult		multaticus
most-	mons		monstro
mucc-	muco		mucosus
multun-	multin		multinummus
murr-	muri		muricidus
murt-	myrt		myrtatum, myrteolus, myrtetum
naeuol-	naeuul		naeuulus
nao-	nau		naufylax
nauph-	naufy		naufylax
nec-	neg		neglectus, neglectus, neglegens, neglegenter, neglegentia, neglego
nouemd-	nouend		nouendialis
nubt-	nupt		nuptialis
nung-	nong		nongentesimus
obc-	occ		occaeco, occallesco, occensus, occento, occludo, occumbo, occurro, occurso, occuro
obed-	oboe		oboedientia
obg-	ogg		oggannio
obp-	opp		oppeto, oppexus, oppono, opprimo, opprobrium, opprobro, oppugnatio, oppugnator, oppugno
obscaen-	obsceni		obscenitas
obscaen-	obscenu		obscenus
obst-	obtr		obtrudo
obtract-	obtrect		obtrectatio
occup-	occip		occipio
octag-	octog		octogesimus
ole-	olf		olfactus
omm-	obm		obmento, obmisceo, obmolior, obmoueo, obmutesco
oport-	oppor		opportune, opportunitas, opportunus
opr-	obr		obrepo
ops-	obs		obscaeuo, obscenus, obscuro, obscurus, obsecratio, obsecro, obsecula, obsecundo, obsequens, obsequenter, obsequiosus, obsequium, obsequor, obsero, obseruatio, obseruo, obsessor, obsianus, obsideo, obsidio, obsidium, obsigno, obsisto, obsitus, obsonator, obsonatus, obsonium, obsono, obsorbeo, obstetricius, obstetrix, obstino, obsto, obstrepo, obstringo, obstruo, obstupidus, obsum, obstipesco
opst-	obtr		obtrudo
opt-	obt		obtaedescit, obtego, obtempero, obtendo, obtentus, obtero, obtestor, obticeo, obticesco, obtineo, obtingo, obtorpesco, obtorqueo, obtrectatio, obtrectator, obtrudo, obtrunco, obtueor, obtundo, obturamentum, obturbo, obturo, obtutus
or-	ho		horiola
or-	au		auresco, auricula, auricularius, auriga
ord-	hor		hordeaceus, hordeum
ost-	ust		ustilis
ostri-	ostre		ostrearium, ostreosus
paen-	penu		penuria
paeon-	paeon		paeonicus
pal-	pha		phalangarius
palmo-	palmi		palmipedalis, palmipes
panu-	pani		panicula
passe-	passi		passiolus
ped-	pae		paedagogus, paedicator, paedico, paedico, paedor
peii-	peie		peiero
pel-	pae		paelex, paelicatus
pell-	pael		paelex
pell-	perl		perlectio, perlucidus
pen-	pae		paenultimus
periur-	peiuri		peiurium
perl-	pell		pellecebra, pellicio
phal-	fala		falarica
philu-	phily		philyra
plebic-	plebec		plebecula
plen-	blen		blennus
plos-	plau		plausor, plaustrarius
plost-	plaus		plaustralis
plot-	plau		plautus
plurum-	plurim		plurimum, plurimus
poen-	paen		paenitentia, paeniteo
poll-	paul		paullulus, paululum
pomoer-	pomeri		pomerium
popl-	publ		publicus
praec-	preci		precia
praecent-	praecant		praecanto
pret-	prec		precia
primo-	primi		primipilaris
ptis-	tisa		tisana
pulcr-	pulch		pulchritudo
pux-	pyx		pyxidicula
quadran-	quadria		quadriangulus
quadri-	quadru		quadrupedans, quadrupedus, quadrupes, quadruplator, quadruplex, quadruplicato
quadrig-	quadrin		quadringenti
quadru-	quadri		quadripertitus, quadriuium, quadriuius
quat-	quad		quadriduum
quoi-	cuiu		cuiusnam
quot-	cott		cottidianus, cottidie
quoties-	quotien		quotienscumque
rag-	rha		rhagadia
rec-	ric		riciniatus
recc-	reci		recido
recon-	recom		recompono
reconl-	recoll		recolligo
redd-	redu		reduco, redux
reum-	rheu		rheumaticus
rin-	rhi		rhinoceros
rud-	rau		raudusculum
rus-	rur		rursus
russ-	rurs		rursus
sad-	sed		sedum
saecl-	saecu		saecularis
saep-	sepi		sepia
sama-	same		samera
samb-	sabu		sabucus
sanguinu-	sanguino		sanguinolentus
sapph-	sappi		sappirus
sarcof-	sarcop		sarcophagus
sarr-	sari		sario
sarr-	serr		serracum
satur-	satyr		satyricus
saur-	sore		sorex
scamm-	scamo		scamonia
scaturig-	scaturri		scaturriginosus
sep-	sae		saepes, saepicula, saepimen, saeptum
septemt-	septent		septentriones
set-	sae		saetiger, saetosus
seu-	seb		sebacium
sexd-	sede		sedecim
sifon-	sipho		siphonarius
sil-	sel		seliquastrum
siph-	sipa		siparum
sipon-	sipho		siphonarius
sirp-	scir		scirpea, scirpiculus
sisp-	sosp		sospes
sit-	set		setanius
sob-	sub		suboles
soll-	soli		solistimus
solli-	solif		soliferreum
spaer-	sphae		sphaerita
spintyrn-	spinturn		spinturnix
spon-	spho		sphondylus, sphondylion
sponge-	spongi		spongiosus
sterci-	stercu		sterculinum
sterqui-	stercul		sterculinum
stili-	still		stillicidium
subadr-	subarr		subarroganter
subads-	subass		subassentior
subc-	succ		succenturio, succerno, succido, succingulum, succlamo, succresco, succubo, succumbo
subgill-	suggill		suggillatio
subii-	subic		subices
succ-	subc		subcurator
succed-	succid		succidaneus
sugill-	suggil		suggillatio
sugr-	sugg		suggrunda
summ-	subm		submano, submergo, subministro, submisse, submissim, submissus, submitto, submotus, submoueo, submurmuro, submussus, submuto
sup-	sub		subsiciuus
supp-	supe		supellex
sups-	subs		subscus, subsilio
supt-	subt		subtilitas, subtiliter, subtraho
supter-	subter		subterduco, subterfugio
surp-	subr		subripio
surrip-	subrip		subripio
suss-	subs		subsilio, subsulto
synod-	synho		synhodus
techn-	techi		techina
ted-	tae		taeda
tegm-	tegi		tegimen, tegimentum
tegum-	tegim		tegimen, tegimentum
tent-	temp		tempto
tent-	tens		tensus
thal-	tala		talassio
thens-	thesa		thesaurarius
thur-	tura		turarius
tini-	tine		tineosus
tral-	tran		translaticius, translatio, translatiuus, translatus, transloquor, transluceo, translucidus
tram-	tran		transmarinus, transmeo, transmigro, transmitto
transd-	traduc		traduco
transs-	transc		transcribo, transcripticius, transcriptio
transs-	transe		transero
transs-	transi		transilio
transs-	transp		transpectus, transpicio
transs-	transu		transumptio
tras-	tran		transenna, transpectus
trau-	tran		transuectio, transueho, transuersarius, transuersus, transuerto
tribul-	tribol		tribolus
tric-	trec		trecenties
uae-	uec		uecordia, uecors
uaes-	uesa		uesania, uesanus
uem-	ueh		uehemens, uehementer
uenterc-	uentric		uentriculus
uigila-	uigili		uigiliarium
uill-	uili		uilica, uilicatio, uilico, uilico, uilicus
uinul-	uinol		uinolentia, uinolentus
uitri-	uitre		uitrearius
uiui-	uiue		uiueradix
unae-	unet		unetuicesimani
unet-	unae		unaetuicesima
uniet-	unaet		unaetuicesima
unq-	umq		umquam
uolg-	uulg		uulgaris, uulgarius, uulgatus, uulgo, uulgus
uoln-	uuln		uulnerarius, uulneratio, uulnero, uulnus
uolp-	uulp		uulpes, uulpinus
uolt-	uult		uultur, uultus
uolu-	uulu		uulua, uuluula
uors-	uers		uersicapillus, uersipellis, uersutus
utrob-	utrub		utrubique
zmaragd-	smaragd		smaragdus
