! if there is nothing in column 3 then it is assumed that the singular and plural are the same
bigae	bīgae	bīga ~ae	4
Bisaltae	Bīsaltae	Bīsalta
Bituriges	Biturīgēs	Biturīgēx
Bruttii	Bruttiī	Bruttius
centeni	centēnī	centēnus ~ī	[
Dalmatae	Dalmatae	Dalmata ~ae
Danaides	Danaides	Danaidis
hiberna	hīberna		[
Hyades	Hyades
Lusitani	Lūsītānī	Lūsītānus ~ī	4
manicae	manicae		1
mapalia	mapālia		1
Mazaces	Mazacēs	Mazax Mazacis	4
Nomades	Nomades	Nomas Nomadis, Nomados
noueni	nouēnī	nouēnus	
Nubae	Nubae	Nuba ~ae	4
octoni	octōnī	octōnus	
optimates	optimātēs	optimās optimātis
Pangaea	Pangaea		*
Pergama	Pergama	Pergamum ~ī	4
Pontiae	Pontiae	Pontia ~ae	4
Pygmaei	Pygmaeī	Pygmaeus ~ī	4
quadrini	quadrīnī		*
quaterni	quaternī	quaternus	2	
quinquageni	quinquāgēnī	quinquāgēnus	2
Quirites	Quirītēs	Quirīs Quirītis	4
Remi	Rēmī	Remus
sata	sata		[
septeni	septēnī		[
septuageni	septuāgēnī
Seres	Sēres	Sēr Sēres
singuli	singulī		[
Stoechades	Stoechades		*
sucerdae	sucerdae	sucerda ~ae	4
Symplegades	Symplēgades	Symplēgadas Symplēgados	4
tenebrae	tenebrae		[
Tralles	Trallēs	Trallis
trigae	trīgae		[
trini	trīnī		[
uirgulta	uirgulta	uirgultum ~ī	4
Ubii	Ubiī	Ubius ~ī m.	4
ambages	ambāgēs		[
Locri	Locrī		*
mysterium	mystērium	mystērium ~ī(i)	4
