!! (written months after the fact) I'm pretty sure this work by if the word ends with $ that it is in fact
! a double prefix.  
! if the line begins with __ and ends with * then all the words below it begin with that double prefix
! if / is in the word then it is manually divided
__interpre__
interpretatiuncula -- a brief explanation
interpretamentum -- an explanation, exposition, translation, interpretation
interprimo -- to press, squeeze to pieces, to crush
interpretor -- to explain, expound, interpret, understand, conclude, infer, comprehend, understood, inferred, To decide, determine, To translate, impers.
interpretium -- the difference between the buying and selling price, profit
interpreto -- c. interpretor.
__contradi__
contradictiuncula -- légère contradiction
contradico -- to speak against, contradict
contrado -- to deliver together, wholly
__praeex__
prae/ex/ercitamentum -- a previous, preparatory exercise
praeexisto -- int., préexister
__ae__
aedificatiuncula -- a little building
aequipollentia -- Boet. équivalence.
aedificatoria -- Boet. architecture.
aequiclinatum -- clinatus), fig. de gram. consistant dans la répétition des mêmes cas
aequiparantia -- a comparison
aequiperantia -- a comparison
aequisonantia -- Boet. unisson.
aedificiolum -- petit édifice
aequinoctium -- the equinox
aegyptilla -- a precious stone once found in Egypt, a kind of onyx
aequamentum -- an equalling, requiting
aequidiale -- the equinox
aequilibrium -- a level, horizontal position, equilibrium
aequipondium -- an equal weight, a counterpoise
aerelauina -- mot forgé par Varr. L. 8, 62, endroit où l'on nettoie le cuivre.
aerifodina -- mine de cuivre.
aeditutimus -- one who keeps, takes care of a temple, the keeper, overseer of a temple, aedituus, liminium
aequipero -- to compare, liken, To equal, come up to, rival
aegrimonia -- sorrow, anxiety, trouble
aegrimonium -- malaise moral, chagrin, peine morale
aeolipilae -- vessels, instruments, for investigating the nature of the wind, eolipiles
aequilauium -- a half of the whole, half, washing
aequilotium -- c. aequilavium.
aequiparo -- Act., to put a thing on an equality with another thing, to compare, liken;, ad, cum, dat.
aequiualeo -- to have equal power, be equivalent
aeramentum -- that is prepared from copper, bronze;, a copper, bronze vessel, utensil
aeromantia -- divination from the state of the air, a&euml;romancy
aesculetum -- a forest of oaks
aegrominium -- malaise moral, chagrin, dépit, langueur.
aerophagia -- Petr. plat d'oiseaux.
aerumnulae -- crochets (pour porter les fardeaux).
aescolanus -- 
aestuarium -- a tract overflowed at high tide, salt marsh, An inlet of the sea, A bay, firth
aetatula -- a tender age
aedicula -- a small building intended for a dwelling.
aedilatus -- qualité d'édile, édilité.
aeditimor -- to keep, take care of a temple, aedituor.
aeditimus -- old for aedituus.
aeditumor -- to keep, take care of a temple, aedituor.
aeditumus -- gardien d'un temple.
aegilopa -- A disease of the eyes, a lachrymal fistula, a tumor in the inner corner of the eye
aegilopium -- a disease of the eyes, a lachrymal fistula, an ulcer in the inner corner of the eye
aerizusa -- a kind of precious stone;, the turquoise
aerugino -- to become rusty, cankered
aerumna -- toil, hardship, distress, trouble, tribulation
aegithus -- a small bird, the titmouse, the red linnet
aequidies -- Gloss. équinoxe.
aerusco -- to get money by going about and exhibiting tricks of legerdemain, to play the juggler
aesculus -- the Italian oak (with edible acorns):
aethalus -- a sort of grape in Egypt, the soot-grape
aethera -- [néol. pour aether
aeterno -- to perpetuate, immortalize
aedituus -- a custodian of a temple, sacristan, poets
aeditua -- a female overseer of a temple
aedituo -- Tempelhüter sein
aerarium -- part of the temple of Saturn at Rome, in which the public treasure was kept, the treasury, the public treasure, finances, to render an account to the treasury, a fund reserved for extreme public necessity, a special fund
aeraria -- a mine
aethra -- the ether, sky, air:
aethria -- Aethria (ancien nom de l'île de Thasos).
aegusa -- (Lebaigue P. 38) Eguse (une des îles Egates).
aelurus -- a cat
aeruca -- a kind of verdigris
aetoma -- Inscr. faîte triangulaire d'une maison ou fronton d'un édifice.
aegitus -- un épervier.
aequo -- to make equal, equalize, raise, returns equal love, extend, abolished, play all night, kept step to the song, equally vested in the two parties, raise, distribute equally, made on equal terms, To place on an equality with, compare, to make level, even, smooth, make as long as the enemy's, To become equal, equal, come up to, attain, reach, to reach, grow as high as the ridges, speak worthily of the achievements, lament adequately, rival by his spirit, keep pace with, as swift as the winds, as fine as mist, draw even with her mate
aequum -- a plain, level:
aedus -- a young goat, a kid
aereum -- a copper color
aera -- -I. a weed among grain; darnel, tare, or cockle -II. counters; hence also the items of a computed sum
aero -- - tr. - garnir d'airain.
aeuum -- neverending time, eternity:
__perad__
peradulescentulus -- ed
__aba__
abarticulamentum -- Placit. articulation.
abauunculus -- great-greatuncle;
abaestumo -- - intr. - mot forgé = autumo.
abagmentum -- a means for procuring abortion
abalieno -- to convey away, make a former transfer of, sell, alienate
abaculus -- a small cube or tile of colored glass for making ornamental pavements
abaestuo -- to hang down richly
abigo -- to drive away, drive off, to drive away, carry off, to force a birth, to drive away, repel, expel
abago -- - tr. - 1 - chasser, renvoyer, éloigner. - 2 - pousser devant soi, emmener, détourner, voler. - 3 - expulser, faire disparaître, dissiper.
abaeto -- - intr. - s'en aller.
abarceo -- - tr. - empêcher, tenir éloigné, éloigner.
abacus -- a table of precious material for the display of plate
abauia -- mother of a great-grandfather, of a great-grandmother
abauus -- a grandfather's grandfather, an ancestor
__adse__
adsentatiuncula -- a bit of flattery
adsequor -- to follow up, overtake, come up with:
adseuero -- to affirm, insist on, maintain, assert, aver, Is this seriously maintained?&mdash;To show, prove
adsecula -- a follower, sycophant
adseruio -- to help, assist, strengthen (once):
adsector -- to wait upon, follow;
adsentio -- to agree with, assent, approve:
adsentior -- to give assent, approve, agree with:
adsensus -- an agreement, assent, approval, approbation, fulfil their duty by assent, An acceptance as real, an echo
adsentor -- to assent constantly, flatter, fawn, in everything
adsideo -- to sit by, sit near, attend, is to be classed with, To sit with, To settle, remain, To invest, lay siege to
adsido -- to take a seat, sit down, resume one's seat:
adsecla -- a follower, attendant
adseruo -- to watch over, keep, preserve, guard:
__depre__
deprecatiuncula -- a little deprecation, a trifling plea for pardon
deprehendo -- to take away, seize upon, catch, snatch
deprehensa -- Fest. peine disciplinaire.
deprecor -- to avert by prayer, deprecate, plead against, beg to escape, seek to avoid
deprendo -- to seize/catch; to catch napping/redhanded; to surprise/pounce on; to arrest; to intercept;
deprensa -- a species of military punishment, more severe than, but milder than
deprimo -- to press down, weigh down, sink down, depress, To sink, to press down, depress, overwhelm, to silence, To depreciate, disparage
depretio -- to lower the price of, to undervalue, to depreciate
__indi__
indignatiuncula -- slight indignation
indigetamenta -- religious books containing the names of the gods and prescribing the mode of worshipping them
indigitamenta -- religious books containing the names of the gods and prescribing the mode of worshipping them
indifferentia -- want of distinction, difference, similarity, equivalence
indiligentia -- carelessness, heedlessness, negligence
indicatura -- an indicating, rating, value, price, rate, physicians, fees for curing diseases
indigentia -- need, want, indigence, Insatiableness, insatiable desire
indipiscor -- to obtain, attain, reach, seize
indicina -- a notice, information, summons
indiculus -- a short list, catalogue
indigeries -- dyspepsie
indigeto -- to call upon, invoke
indigito -- to call upon, invoke
indilucesco -- to begin to grow light
indiuiduum -- an atom, indivisible particle
indignor -- to deem unworthy, be indignant, despise, resent, be offended, disdaining to bear, is not fit
indico -- to declare publicly, proclaim, publish, announce, appoint
indiciua -- the informer's reward
indo -- to put into, insert, to introduce, to give, apply, confer
indipisco -- to begin, commence
__compre__
comprehensibile -- 
comprehendo -- to bind together, unite:
comprehenso -- to embrace
comprimo -- to press together, bring together, compress, close:
compresso -- to press, oppress
comprecor -- to pray to, supplicate, implore:
__empro__
emprosthotonici -- personnes frappées d'emprosthotonos, sujettes à l'emprosthotonos
emprosthotonia -- a disease in which the limbs are drawn forward and stiffen
__praeco__
praecognoscentia -- connaissance anticipée$
praecognosco -- to foreknow, foresee$
praecorrumpo -- ant
praecolligo -- tr., assembler préalablement$
praecogito -- to ponder beforehand, premeditate
praecordia -- the muscle which parts the chest from the abdomen, midriff, diaphragm, stopped his breath, The entrails, stomach, The breast, heart, lay their breasts upon, folly
praecordium -- diaphragme
praecoepi -- to begin before
praecoquo -- To boil beforehand
praecolo -- to cultivate beforehand, To embrace prematurely
praecocia -- over-hasty, premature, precocious, untimely
__praese__
praesepraesaepium -- an enclosure, a stable, stall, fold, pen
praesentaneum -- a remedy that operates quickly
praeseco -- to cut off before, cut away, cut off, cut out
praesemino -- to sow, plant beforehand
praesentio -- to feel beforehand, perceive in advance, have a presentiment of, presage, divine
praesentia -- a being at hand, presence, presence of mind, Impression, efficacy, effect, at the present time, at the moment, just now, for the present, under present circumstances, to conceal for the time, at hand
praesento -- to place before, exhibit to view, to show, present, hold out, handed, presented to
praesentisco -- to begin to have a presentiment of
praesepio -- to fence in front, to block up, barricade
praeseca -- un chou.
praesepe -- - 1 - toute espèce d'enceinte ou d'enclos; étable, parc à moutons, écurie; qqf. râtelier, mangeoire, crèche. - 2 - habitation, logis, habitation, demeure. - 3 - maison où l'on mange, maison où l'on dîne, table. - 4 - lieu de débauche, mauvais lieu.
praesepia -- c. praesepe.
praesepium -- c. praesepe.
praesero -- to sow beforehand
praeseruio -- to serve
praeseruo -- to observe beforehand
__atra__
atramentariolum -- petit encrier.
atramentale -- encrier.
atramentarium -- an inkstand
atramentum -- a black liquid, blacking, Ink, writing-ink
__circumam__
circumamplector -- - tr. - embrasser, entourer.$
circumamicio -- - tr. - envelopper de toute part.
__comper__
comperendinatus -- an adjournment over one entire judicial day
comperegrinus -- a fellowstranger$
comperendino -- to adjourn over an entire day, cite for the third judicial day, awaiting judgment, reach the end of the pleading
compericlitor -- - intr. - courir des dangers communs.
comperio -- to obtain knowledge of, find out, ascertain, learn, detected in
comperco -- to save, hoard, lay up
comperior -- to ascertain, learn, find out
__condis__
condiscipulatus -- companionship in school
condiscipula -- a female school-fellow
condiscumbo -- int., se mettre à table avec
__discon__
disconuenientia -- want of agreement, inconsistency
disconduco -- not to be profitable, conducive, to be injurious, prejudicial$
disconuenio -- to disagree, be inconsistent
__ina__
inauditiuncula -- a little lecture, lesson
inaudientia -- disobedience
inauratura -- a gilding, Piur.
inargento -- to overlay with silver, to silver
inauguro -- to take omens from the flight of birds, practise augury, divine
inalligo -- tr., lier sur
inaltero -- to include the one in the other
inaquosa -- dry places, desert places
inassero -- to cover with beams
inaudio -- to hear whispered, get an inkling of
inaccresco -- to increase, med.
inaestuo -- to boil in, rage within
inarcto -- to circumscribe, limit
inacresco -- - intr. - Tert. grandir, croître.
inaequo -- to make even, level
inalbeo -- to be white, light
inalbesco -- to become white, pale
inalbo -- to make white, light, to whiten, brighten
inalgesco -- to become cold
inalto -- to raise, exalt
inardesco -- to kindle, take fire, burn, glow
inaures -- ear-drops, ear-rings, ornaments for the ear
inaurio -- to give hearing to, to cause to hear
inauro -- to overlay with gold
inigo -- To drive into, to, to drive
inarmo -- to arm
inarto -- tr., resserrer, diminuer
inausa -- unattempted things, deeds beyond daring
inacesco -- to turn sour at, sour upon
inacisco -- to become sour in, to turn sour
inaro -- to plow in; to cultivate;
inaresco -- to become dry in, to dry up, become quite dry
inaquo -- to turn into water
inalesco -- int., c. inolesco
__incon__
inconsiderantia -- want of reflection, inconsiderateness$
inconsequentia -- want of logical connection, inconsequence$
inconuenientia -- inconsistency, incongruity$
incongruentia -- unsuitableness, incongruity$
inconsonantia -- dissonance, manque d'harmonie.$
incontinentia -- greediness, incontinence
inconruptela -- imperishableness, incorruptibility
inconscientia -- ignorance [d'une chose]$
inconstantia -- inconsistency, inconstancy, changeableness, fickleness$
incontumacia -- die Charakterlosigkeit
inconsultum -- - 1 - défaut de consultation. - 2 - J.-Val. imprudence.
inconcilio -- to win over to one's side, to gain over artfully
inconsilium -- ill-advisedness, thoughtlessness
inconstruo -- to build up with$
__praeterin__
praeterinquiro -- to inquire further$
__subco__
subcornicularius -- a sub-adjutant, second adjutant
subcorrigo -- - tr. - corriger un peu [un livre] : Eugen. praef.
subcoeno -- - intr. - entamer un repas par dessous, manger les restes.
subcoquo -- to cook a little, med.
__subprae__
subpraefectura -- sous-préfecture.$
__superab__
superabundantia -- superabunaance
superabundo -- to be very abundant, to superabound
superabluo -- to wash off above$
__supera__
superaccommodo -- to fit on above, put on$
superargumento -- - intr. - Tert. prouver en outre, ajouter dans l'argumentation.
superargumentor -- seinen Beweis darauf gründen, außerdem beweisen - Beweis führen - führen  - oben darauf hinstreuen - oben daraufhin bestreuen
superappono -- - tr. - Boet. placer dessus.$
superaugmentum -- an additional, further increase
superascendo -- - tr. - Iren. dépasser.$
superaspergo -- to scatter upon, over, med.
superattraho -- tr., tirer au-dessus de$
superaggero -- to heap over$
superalligo -- - tr. - M. Emp. attacher par-dessus.$
superappareo -- to appear above$
superaccipio -- - tr. - Greg. prendre par-dessus le marché.$
superaceruo -- to heap on, pile up
superalluo -- to wash over, flow over$
superasto -- to stand over$
__superin__*
superindumentum -- an ouler garment
superinstruo -- to build over, upon; to arrange over one another
superintellego -- tr., comprendre en outre
superinsterno -- to spread over, lay thereupon
superinstillo -- to drop upon
superinstrepo -- to sound above
superinpono -- to put, place, lay upon
superincendo -- to inflame more, greatly
superincerno -- to sift upon
superincumbo -- to lay, cast one's self upon
superindictum -- an extraordinary impost
superinduco -- to draw over, cover over
superinfundo -- to pour over, upon
superingero -- to bring upon, to casl, heap upon
superingredior -- - dép. tr. - Col. enjamber, franchir (en enjambant).
superinicio -- to throw on, cast over, scatter thereupon
superiniicio -- - tr. - Virg. Plin. jeter par-dessus, répandre sur.
superinspicio -- to oversee, to superintend, med.
superintendo -- to have the oversight of, to superintend
superinsulto -- darauf springen, -herumspringen, -sich herumtummeln
superincido -- to fall from above, fall down thereupon
superincubo -- to lie over, lie thereupon
superinduo -- to put on over
superintego -- to cover over
superinundo -- to overflow;
superinungo -- to smear over, to besmear, anoint
superinueho -- to carry above, over
superinlino -- - tr. - 1 - Cels. oindre de, enduire de. - 2 - Cels. étendre sur.
superintono -- - intr. - résonner sur.
superincresco -- to grow over, upon
__excon__
exconcrescentia -- die Verdichtung
exconsulatus -- situation, dignité de l'ex-consul
exconcinno -- - tr. - bien arranger.
excondo -- to form, exhibit
__sua__
suauifragrantia -- fragrance
suauiloquentia -- sweetness of speech, agreeableness
suauifragantia -- parfum suave
sualiternicum -- a kind of reddish amber
suaueolentia -- a sweet odor, fragrance
suauiludius -- one that delights in plays, a lover of plays
suauillum -- a kind of sweet cake
suauiolum -- a little kiss
suasoria -- discours du genre délibératif.
suauio -- embrasser, baiser.
suauior -- to kiss
suauium -- a kiss; see savium
__ana__
anathematismus -- excommunication.
anacoeliasmus -- remède laxatif.
anathematizo -- to anathematize, to put under the ban$
anaclinterium -- a cushion for leaning upon
anaglypharius -- ciseleur, qui s'occupe des bas-reliefs.
anagnosticum -- Ennod. morceau de lecture.
analectrides -- coussinets
anachoreta -- a hermit, an eremite, recluse, anchorite
anacliterium -- dossier d'un lit de repos.
anatocismus -- interest upon interest, compound interest.
aniticula -- A little duck, a duckling
anapaestum -- a poem in, anap&oelig;sts
anatomica -- anatomie.
anaglypta -- work in bas-relief, anaglypha.
analecta -- he that collected the crumbs, left after a meal
anaphora -- A rising, mounting up, the rising of the stars$
anaphorus -- die Tragstange
anathemo -- c. anathematizo.$
anactorium -- a plant, sword-grass
analogium -- Isid. pupitre, lutrin.
anasceua -- réfutation
anatina -- duck-flesh, duck
anatomia -- anatomie.
an/audia -- loss of speech, dumbness
anaxo -- tr., nommer
__circumad__*
circumadspicio -- regarder autour de soi.
circumadiaceo -- int., se tenir autour
__circuma__
circumassisto -- int., se tenir autour
circumaggero -- to heap up around
circumaspicio -- regarder autour de soi.
circumaufero -- tr., supprimer totalement
circumaperio -- - tr. - ouvrir (chirur.).
circumago -- to drive in a circle, turn round.
circumasto -- ringsherum stehen
circumaro -- to plough around, L.
__circumabs__
circumaufero -- tr., supprimer totalement
__dede__
dedecoramentum -- disgrace, dishonor
dedecoro -- to disgrace, dishonor, bring to shame
__imprae__
impraescientia -- a not knowing beforehand, want of prescience$
impraegno -- to impregnate, make pregnant
__insu__
insufficientia -- insufficiency
insuspicabilia -- fancies, imaginations$
insusurro -- to whisper to, insinuate, suggest
insultura -- a springing, leaping at, upon
insumentum -- Itala. morceau, pièce rapportée.
insularius -- a tenant of an island
insumo -- to take for, apply, expend
insumptum -- expense
insufflo -- to blow, breathe into, upon, Absol.
insulula -- 
insuasum -- a kind of dark color
insucco -- - tr. - mouiller, plonger dans, faire tremper dans, immerger.
insulco -- to furrow, make furrows
insulsae -- 
insuo -- to sew in, sew into, sew up
insula -- an island, isle, A part of Rome encircled by the Tiber, A part of Syracuse cut off by an arm of the sea, An enclosed court, tenement for poor families
insuco -- to soak in, to steep
insudo -- to sweat on, stain with sweat
insupo -- v. insipo.
insuesco -- to habituate oneself, become accustomed, be inured
__interdi__
interdigitalia -- excrescences, between the fingers
interdigitia -- excrescences, between the fingers and toes
interdico -- to interpose by speaking, forbid, prohibit, interdict
interdictum -- a forbiden thing, A prohibition, a provisional decree, interlocutory order, prohibition, interdict, subject to a guardian
interdiarius -- a thief who, steals by day
__praecon__
praeconsumo -- to waste in advance, spend beforehand$
praecontrecto -- to handle beforehand
praecondio -- to season beforehand, med.
praeconium -- the office of a public crier, A crying out in public, proclaiming, publishing, A celebrating, laudation, commendation
praeconor -- to perform the office of public crier, herald, to herald, proclaim; to praise
__praede__
praedetermino -- to fix beforehand
praedemonstro -- to demonstrate beforehand$
praedelasso -- to weary out beforehand$
praedestino -- to set before as a goal, predestine
praedemo -- tr., enlever préalablement
__praedi__
praedicamentum -- that which is predicated, a quality;
praediatura -- the purchase of estates at auction
praediuido -- - tr. - diviser d'avance.
praediuino -- to have a presentiment of, to divine beforehand
praedictum -- something previously said, as if by preconcert, A foretelling, prediction, prophecy, An order, command
praediolum -- a small estate
__praein__
praeintellego -- - tr. - Boet. comprendre d'avance, prévoir.
praeinfundo -- to pour into beforehand$
praeinstruo -- - tr. - Boet. instruire d'avance.$
praeinsto -- - intr. - Boet. insister d'avance sur.$
praeinnuo -- to indicate beforehand$
__praeinter__
praeinterrogo -- - tr. - Boet. interroger auparavant.$
__proa__
proaedificatum -- a balcony
proauunculus -- a great-grandmother's brother
proagorus -- (in Sicilian towns), a director, chief magistrate
proastium -- faubourg.
proauia -- f, a grandfather's, grandmother's mother, a great-grandmother
proauus -- a great-grandfather
__subintro__
subintroduco -- to introduce in secret$
subintromitto -- introduced temporarily$
__superad__*
superadspergo -- - tr. - répandre sur.
superadnecto -- - tr. - joindre encore, ajouter.
superaddo -- to add besides, superadd
superadhibeo -- - tr. - Th.-Prisc. appliquer par-dessus.
superadicio -- to put in, add besides, to superadd
superadiicio -- - tr. - Pall. surajouter.
superadmiro -- to admire, wonder at exceedingly
superadmiror -- - dép. tr. - Facund. avoir la plus grande admiration pour.
superaduolo -- - intr. - arriver en volant, accourir.
superadsto -- to stand over
__superde__
superdestillo -- to drop, trickle upon
superdestilio -- tr., répandre d'en haut goutte à goutte
superdeligo -- to bind upon, over
__superem__
supereminentia -- supereminence
superemico -- to spring, burst forth over
superemineo -- to overtop, surmount, rise above, tower over
__superim__*
superimpono -- to put upon, place over, set above
superimmitto -- to throw over, upon
superimmineo -- to hang over, overhang
superimineo -- darüber emporragen#
superimpleo -- $
__ado__
adolescentula -- a very young maiden;
adolescentulus -- a very young man, a young soldier, a recruit
adolescenturio -- to behave like an
adulescentia -- youth, Youth, young men
adolescentior -- to behave like an
adoperio -- >to cover, cover over:$
adopertum -- that which is mysterious, a mystery
adopperior -- - tr. - attendre.$
adoptulus -- fils adoptif.
adordino -- to set in order, to arrange
adoperor -- - intr. - faire un sacrifice.
adopinor -- to think, suppose, conjecture further
adonidium -- 
adopto -- to take by choice, select, choose, adopt:
adorior -- to approach as an enemy, fall upon, assail, assault, attack:
adorno -- to provide, furnish, fit out, equip, make ready:
adoleo -- to turn to vapor, to burn in sacrifice, the prescribed burntofferings, to fire up, to fill with sacred fires, to destroy by fire
adolesco -- up to:
adonium -- a plant, a species of southernwood, Adonis horti
__circumco__
circumcolentes -- riverains
circumcolo -- to dwell round about, dwell near:
__circumin__*
circuminspicio -- tr., examiner tout autour
circuminiicio -- - tr. - élever autour.
circuminsidior -- int., tendre des pièges autour
circuminuoluo -- to involve all around, to enclose, envelop
circumincido -- tr., inciser autour
circuminicio -- to throw up all around
__circumpro__*
circumproiicio -- tr., répandre autour
__coen__
coenatiuncula -- a small dining-room
coenobiolum -- petit couvent, petit monastère
coenaturio -- to have an appetite for dinner
coenobita -- a cloister-brother, a monk
coenolexia -- expression banale
coenoteta -- propriété commune, analogie
coenomyia -- the common fly
coenito -- to dine often, much, to be accustomed to dine, to dine
coenobium -- a cloister, convent
coenomya -- mouche commune.
__coe__
coeuangelista -- compagnon d'apostolat
coepiscopatus -- an associate episcopate
coepiscopus -- an associate bishop
coepulonus -- a fellowbanqueter, companion at a feast
coelibatus -- celibacy, single life
coerceo -- to enclose on all sides, hold together, surround, encompass, To restrain, confine, shut in, hold, repress, control, controls, to control, confine, restrain, limit, To hold in check, curb, restrain, tame, correct, of maintaining order, corrected
coeliaca -- stomach remedy
coepulor -- to feast together
coepto -- to begin eagerly, begin, undertake, attempt
coepio -- to begin, commence, P, begun, commenced, undertaken, in process of creation, sought, to begin, be begun, take a beginning, commence, originate, arise
coeptum -- a work begun, beginning, undertaking
coerro -- to go, wander about together
caelum -- the sky, heaven, heavens, vault of heaven, sign, constellation, struck by lightning, of divine descent, at break of day, in the evening twilight, to observe the signs of heaven, to appear, to drop from the sky, to throw everything into confusion, the breadth of the sky, of the grave of Caelius, A sky, clime, zone, region, The air, sky, atmosphere, temperature, climate, weather, the open air, heaven, the height of honor, prosperity, happiness, praised to the skies, deprived of his position, very happy, extolled
coelo -- - tr. - orner de reliefs, ciseler, graver, buriner.
cogo -- to drive together, collect, crowd, bring together, summon, congregate, convene, collected, to exact, to extort, levy, to convene, to be summoned, to thicken, condense, curdle, coagulate, gather, To contract, narrow, straiten, To force, drive, press, to bring up the rear, are the last, my resources are brought into straits, restrict. &mdash; To urge, force, compel, constrain, are rolled up tightly, spontaneously, forced, uncontrollable, on compulsion, To conclude
coero -- c. curo.
__dia__
diaristolochia -- extrait d'aristoloche
diacentaureum -- extrait de centaurée.
diagentiana -- antidote à base de gentiane
diaherpyllum -- remède où il entre du serpolet
dialecticus -- dialectical, logical; reasoning (creatures); (dialectical method of Academy);
dialectica -- dialectics, logic
diacatochia -- possession
diacatochus -- a possessor
diaconissa -- a deaconess
diaetarcha -- c. diaetarius
diaetetica -- - 1 - la diététique. - 2 - la médecine.
diaetetici -- physicians who cure by diet
dialogista -- an able disputant
diapsoricum -- an eye-salve
diatretarius -- one who does perforated, filigree work, a turner, carver
diacardamum -- potion à basse de cresson
diacastoreum -- injection à base de castoréum
diacherale -- sorte de collyre
diahyssopum -- remède à base d'hysope
diaconicum -- a place for storing the vessets of the altar
diaglaucium -- a salve made from the herb
dialectrum -- pilule à base d'ambre (pour les hémorragies).
dialibanum -- a salve made with frankincense
diatriba -- school for rhetoric/philosophy; learned discussion (L+S);
diacitrium -- potion au citron.
diaetarius -- a, valet-de-chambre
diaeteta -- an umpire
diagrydium -- the juice of the plant
diaphonia -- disharmony, discord
diarrhoea -- diarrh&oelig;a
diastoleus -- an auditor of accounts
diatritus -- the return of a fever on the third day
diaphora -- distinction
diathyra -- an enclosure
diatreta -- pierced work, filigree-work
diacona -- Fort. diaconesse.
diaconia -- Cass. le diaconat.
diaconium -- the office of deacon, deaconship
diaconus -- a servant, minister of the church, a deacon
diacopus -- an opening, sluice in a dam
diacopi -- Einschnitte, Durchbrüche
diatonum -- the natural, diatonic series of notes, the diatonic scale
diacolea -- c. chamaemelum
diaeta -- a regular mode of living, diet
diaula -- a plant
dianoea -- by which a fact is exhibited instead of a conception
__praeab__
praeabundantia -- der Überfluß
__praea__
praeargumentor -- d., établir des principes préalables
praeaudio -- to hear beforehand
praeaccipio -- to admit antecedently$
praeacuo -- to sharpen before, at one end, to sharpen to a point
praeapto -- tr., arranger préalablement
praeaequo -- to make equal before
__praetere__
praeterequito -- vorbei-, auf und nieder reiten
__subterin__
subterintendo -- to look askance
subterinsero -- to insert
__superper__
superperspicio -- to look away over$
__perse__
perseuerantia -- steadfastness, perseverance, obstinacy
persephonium -- wild poppy
persequor -- to follow perseveringly, follow after, follow up, pursue
perseuero -- to abide, adhere strictly, continue steadfastly, persist, persevere, kept on its course, persisted
perserpo -- to creep perpetually, to crawl
persedeo -- to remain sitting, sit continuously
persideo -- trict
persido -- to sink down, penetrate
perseco -- to cut up, extirpate, cut out
persector -- to follow, pursue eagerly, to investigate
persentio -- to feel deeply
persentisco -- to perceive clearly, detect
persenesco -- to grow old
perseruo -- to preserve
perseruio -- to serve throughout
persero -- to stick, run through
__abo__
abominamentum -- a detestable thing
aboriscor -- dep., to perish, die
aboleo -- to destroy, abolish, efface, put out of the way, annihilate, to destroy the, flesh
abomino -- pass., abominated, accursed
abominor -- orig. of bad omens, to deprecate, wish to nullify:
abortiuum -- An abortion
abortio -- to miscarry, aboriendi
aborior -- to pass away, disappear, be lost; to miscarry, be aborted; to set (sun/planet/star)
abortium -- avortement.
aborto -- to bring forth prematurely
abortum -- an abortion, miscarriage.
abolla -- a mantle, cloak,
abolesco -- to decay gradually, vanish, disappear, die out
__aen__
aenigmatista -- one that proposes riddles, one that speaks in riddles, an enigmatist
aenitologium -- a dac tylic verse with an iambic
aenulum -- a small bronze vessel
aena -- chaudière.
aenum -- a bronze vessel
__circumamb__
circumambulo -- to walk around
circumamburo -- - tr. - brûler tout autour.
circumambio -- - tr. - entourer.
__circume__
circumequito -- to ride around:
circumerro -- to wander round, stroll about, to pass through
circumago -- to drive in a circle, turn round.
__circumre__
circumretio -- to enclose with a net, insnare.
__circumse__
circumseparo -- to separate around
circumsedeo -- to sit around, surround, besiege, blockade, invest, encompass, beset:
circumsideo -- to sit around a person or thing, to surround.
circumseco -- to cut around:
circumsero -- to sow, set, plant around something
__circumtra__
circumtraho -- to draw, drag around, fin;
__coo__
cooperimentum -- a covering
coopertorium -- a cover
coopertura -- au fig. couverture, voile.
cooperio -- to cover, cover over, overwhelm, bury, P. pass., buried, involved, covered
coonusto -- c. coonero.
cooperor -- to work with, together, combine, unite
coonero -- - tr. - charger (de plusieurs objets à la fois).
coopto -- to choose, elect, admit by election, appoint to office
coorior -- to come forth, stand up, arise, appear, rise, break forth, To arise, break out, begin, To rise in opposition, stand up in hostility, rise, break forth
coorno -- - tr. - orner ensemble.
coolesco -- c. coalesco.
__deamb__
deambulatorium -- a gallery for walking
deambulacrum -- a place to walk in, a promenade, walk
deambulo -- to walk abroad, take a walk, promenade
__disse__
dissepimentum -- Fest. séparation (entre deux choses).
dissemino -- to spread abroad, disseminate
disseparo -- to part, divide
disserenasco -- to clear up, grow clear
dissereno -- tr., éclaircir, rendre serein
dissentio -- to differ, dissent, disagree, be at odds, contradict, quarrel
dissentior -- c. dissentio.
dissideo -- to sit apart, be remote, to be at variance, disagree, differ, is distracted, to be unlike, be dissimilar, differ, disagree, sits awry
dissero -- to examine, argue, discuss, speak, harangue, discourse, treat
disserto -- to discuss, debate, treat
disseco -- to cut asunder, cut in pieces, cut up, dissect
dissecto -- fréq. de disseco
dissepio -- to part off, to separate, divide
disseptum -- c. disseptio.
disserpo -- to creep about, to spread imperceptibly
__exse__
exsecramentum -- execration
exsequialia -- funeral rites
exsequiarium -- don fait à l'occasion des obsèques.
exsecratus -- accursed, execrable, detestable
exsequor -- to follow to the grave
exsequia -- funeral procession/rites (pl.), obsequies; [~as ire => attend funeral];
exsequiae -- a funeral procession, funeral obsequies, to attend a funeral
exsequior -- to perform the funeral rites, to bury
exsequium -- repas de funérailles.
exsecror -- to curse, utter curses, execrate, abhor, To take an oath with imprecations, having sworn to
exsecro -- accursed, execrable, detestable
exseco -- to cut out, cut away, remove
exsercio -- to patch up, mend;, to amend, repair, restore
exserto -- to stretch out, thrust forth
__imper__
impersonatiuus -- the impersonal mood, the infinitive
imperfundies -- filth, impurity$
impermisceo -- to mix in, mingle$
imperfectum -- $
impertio -- to share with, give a part, communicate, bestow, impart, salutes thee heartily, wouldst show, To bestow, direct, assign, give, devote, To take as a partner, cause to share, present with
imperatum -- a command, order, obeys, according to orders
imperito -- to command, govern, rule, be supreme, my decree is just
imperitia -- inexperience, ignorance, awkwardness, in lemm.
impertior -- to take as a partner, make a sharer in
imperco -- to spare
imperium -- a command, order, direction, injunction, Command, authority, control, power, ascendency, sway, arbitrarily, give the order yourself, subject to, Supreme power, sovereignty, sway, dominion, empire, supremacy, authority, sole dominion, dominion, sovereignties, A public office, magistracy, term, Command-in-chief, supreme command, military authority, be under the same military head, A dominion, realm, empire, of the court, an authority, officer, general, military and civil authorities, rule, control, ambition
impero -- to command, order, enjoin, bid, give an order: Pa, Ch, for orders, to receive orders, To exercise authority, command, rule, control, govern, To be master, rule, control, govern, you are sovereign, make productive, is master or man, To give orders for, make requisition for, levy, require, impose, demand, prescribed
__impro__
improuidentia -- want of foresight, improvidence$
impropero -- to hasten into, enter hastily;
improperium -- a reproach, taunt
improbito -- to disapprove strongly, condemn
improuisum -- that which is unforeseen, an emergency, de, unexpectedly, suddenly, ex$
improprium -- something improper, impropriety, faultiness
improbo -- to disapprove, blame, condemn, reject
__inabs__
inabstinentia -- intempérance.
__inco__
incorruptela -- imperishableness, incorruptibility
incogitantia -- thoughtlessness, inconsiderateness
incohamenta -- first principles, rudiments, elements
incorporale -- -I. an incorporeal thing, that which is unsubstantial, immaterial -II. an intangible possession, a right
incognosco -- to learn, find out$
incoenceno -- to dine there, to dine in, at a place
incorporo -- To fasten, mark in, upon a body.
incoctilia -- vessels overlaid, washed with metal, tinned vessels
incogito -- to contrive, design
incoprio -- to defile, abuse, revile
incoquo -- to boil down, boil, seethe
incoho -- to begin/start (work); to set going, establish; to draft/sketch/outline; to enter upon;
incolo -- to be at home, abide, dwell
incoxo -- to bend down, to cower, squat down
__inde__
indeficientia -- an unfailing supply
indesponsata -- celle qui n'est pas fiancée.
indecentia -- unseemliness, impropriety
indecoro -- to disgrace, disfigure
indecorae -- ill-favored women
indebitum -- that which is not due, the performance, payment of which is not due
indepto -- - tr. - atteindre.
indipiscor -- to obtain, attain, reach, seize
indeceo -- to misbecome;, acc. pers.
indecet -- être inconvenant.
__indis__
indisciplina -- want of education
__inex__
inexperientia -- inexperience
__inob__
inobaudientia -- Tert. désobéissance.
inoboedientia -- disobedience
inobsequentia -- disobedience
inobseruantia -- inattention, negligence, irregularity
inobedientia -- désobéissance.
inoblector -- to take delight in
inobscuro -- 
inobaudio -- to disobey, be disobedient
inoboedio -- to disobey, be disobedient
inobedio -- - intr. - désobéir.
__interco__
intercolumnium -- a space between two columns, intercolumniation
__intercon__
interconcilio -- to gain the favor of, conciliate
__praeem__
praeeminentia -- pre-eminence
praeemineo -- g, delightful
__praemale__
praemaledico -- to curse beforehand$
__praesu__
praesuspecto -- to suspect beforehand$
praesumo -- to take before, take first
praesulatus -- the office of a superintendent
praesulto -- to dance before, swagger before
praesulco -- tr., tracer d'avance
praesudo -- to sweat before
praesulor -- to be a superintendent
praesuo -- to sew over, sew up;, to cover over
__praetra__
praetractatus -- abl. sing., a preliminary treatise, an introduction, preface
praetracto -- - tr. - Tac. examiner d'abord.
__procon__
proconsulatus -- the office of a proconsul, proconsulate
__prose__
proserpinaca -- a plant, also called
prosecutoria -- a letter relating to taking something in charge, a letter of authorization
prosequor -- to follow, accompany, attend, follow after, escort
proseucha -- a place for prayer, oratory
prosemino -- to sow, scatter, plant
proselyta -- 
proserpo -- to creep forward;
proseco -- to cut off, cut away
prosecta -- entrailles de la victime.
prosectum -- v. prosecta
prosico -- - tr. - 1 - couper, amputer. - 2 - découper (les entrailles d'une victime). - 3 - sacrifier, offrir en sacrifice. - 4 - fendre (la terre), labourer.
prosecro -- to sacrifice
prosentio -- to perceive beforehand
prosequium -- attendance
proseptum -- domaine, enclos
prosero -- to stretch forth, extend
__recom__
recomminiscor -- to recall to mind, recollect
recommentor -- se rappeler.
recompenso -- tr., compenser, récompenser
recompingo -- to join together again, reunite
recommoneo -- to remind again
recompono -- - tr. - remettre, rajuster.
__retrans__
retransmitto -- tr., repasser, retraverser
retransmeo -- tr., passer de nouveau
__subdi__
subdiaconatus -- sous-diaconat.
subdiaconus -- a sub - deacon
subdiffido -- to be distrustful
subdiuido -- to subdivide, med.$
subdialia -- open galleries, terraces;
subdo -- to put under, set to, apply, plunge into, Fig., to bring on, furnish, supply, yield, afford, To put in stead, substitute, To subject, make subject, To substitute falsely, forge, counterfeit, make up, spread falsely
subdito -- - tr. - donner en gage.
subdiuum -- le grand air, le plein air.
__subdis__
subdistinguo -- to make a smaller interpunction, a colon
__subin__
subincrepito -- int., faire un léger craquement$
subintellego -- to understand, perceive a little, med.
subintelligo -- - tr. - apprendre par des bruits confus, comprendre un peu, supposer, soupçonner, présumer.
subinstillo -- - tr. - verser goutte à goutte.
subinscribo -- to subjoin$
subingredior -- int., entrer avec précaution [dans]$
subinduco -- introduire subrepticement ou frauduleusement.$
subinfero -- to subjoin, add$
subinuideo -- to be somewhat envious of$
subinuito -- to suggest to, invite by a hint
subinuolo -- - intr. - Aug. voler peu à peu.$
subinflo -- to puff up somewhat; pass., part., somewhat puffed up, inflated$
subinfluo -- couler sous.$
subintro -- to go into secretly, to enter by stealth, steal into
subindo -- to subjoin, add$
subina -- Enn. Tert. une lance (pour la chasse à l'usage des Illyriens).
__subteran__
subteranhelo -- to pant, gasp beneath
subterannoto -- tr., noter en dessous
__suo__
suouetaurilia -- a sacrifice of lustration, consisting of a swine, a sheep. and a bull.
__supercom__
supercompono -- to place together upon, on the top, med.$
__supercon__
superconcido -- to cut in pieces over$
supercontego -- to cover over
__superco__
supercorrigo -- - tr. - Hier. corriger en sus.
supercorruo -- to fall down thereon$
__superex__*
superexcurro -- to run, stretch over, to spread over
superexsulto -- to leap up, exult greatly
superextendo -- to stretch over, cause to cover
superextollo -- to raise, exalt above
superexalto -- to exalt, above others
superexcedo -- to surpass
superexcresco -- - intr. - Gloss. croître par-dessus.
superexigo -- to demand, exact over and above, to excess$
superexsto -- int., exister au-delà
__superob__
superobumbro -- to overshadow$
superobruo -- to cover over, overwhelm$
__superpro__
superproiicio -- - tr. - Cass. jeter au-dessus.$
__comprae__
compraehendo -- to lay hold of something on all sides; to take, catch hold of, seize, grasp, apprehend; to comprehend, comprise
compraecido -- to cut off at the same time$
compraendo -- to lay hold of something on all sides; to take, catch hold of, seize, grasp, apprehend; to comprehend, comprise
__condi__
condimentaria -- salade
condimentum -- spice, seasoning, spice, ornament, seasoning
condiaconus -- diacre avec d'autres
conditura -- preparing; preserving (fruits); preserving material; condiment, spice; jam;
condico -- to agree, make an engagement, covenant, promise:
condictum -- pacte, convention.
conditiuum -- a tomb
condio -- to make savory, season, spice, concoct, To make fragrant, To embalm, to cultivate, ornament, season, spice, soften, temper, to set off, to mitigate, more amiable
condo -- to put together, make by joining, found, establish, build, settle, before the foundation of Rome, they settle, To erect, make, construct, build, found, To compose, write, celebrate, treat, describe, To establish, found, be the author of, produce, make, To put away, lay by, lay up, store, treasure, to imprison, safe, To preserve, pickle, To inter, bury, things blasted, recorded, to bury, dispose of, to complete, close, To conceal, hide, secrete, suppress, make away with, sheathe, shut, retire, place in ambush, To strike deep, plunge, bury
condita -- the laid up store
conditum -- to cultivate, ornament; to make pleasant, agreeable; to soften, temper
__exprae__
expraepositus -- $
__inan__
inanilogista -- einer, der vergeblich redet
inanimentum -- emptiness
inanimo -- tr., animer
__purpur__
purpuramentum -- a purple vestment
purpuretica -- an entrance built of porphyry
purpurissum -- masc.
purpurissus -- a kind of dark purple color
purpuraria -- marchande de pourpre [étoffes] / teinturerie en pourpre
purpura -- purple color, purple; purple dye; purple-dyed cloth;
purpurasco -- to grow purple
purpuresco -- c. purpurasco
purpuro -- Act., to purple, to make purple-colored, to dye with purple, to darken
__recon__
reconstringo -- to bind up again$
reconditorium -- Isid. endroit pour serrer.
reconsidero -- tr., considérer de nouveau$
reconcinno -- to set right again, repair$
reconcludo -- to shut up, enclose, med.$
reconduco -- To hire anew, to farm, contract for again$
recongero -- tr., assembler$
reconsigno -- to mark again$
reconuinco -- convaincre entièrement$
reconfirmo -- to strengthen again$
reconiungo -- tr., réunir à nouveau$
reconuerto -- to turn back again$
reconcilio -- to procure again, regain, recover, restore, re-establish$
recondo -- to put up again, put back, lay up, put away, hoard, shut up, close, hide, conceal, bury$
recondita -- remote, sequestered places
reconditum -- a secret place, Plur.
reconualesco -- to recover health again$
reconstruo -- tr., reconstruire$
reconflo -- to blow up again, rekindle$
__suba__
subalternicum -- a kind of reddish amber
subausculto -- to listen secretly. eavesdrop
subarundino -- tr., échalasser
subaudio -- to understand, supply a word; to hear a little;
subaccuso -- to blame somewhat, find a little fault with$
subaemulor -- to accumulate secretly
subadmoueo -- to bring close$
subagito -- to lie with illicitly
subalare -- an under-girdle
subalares -- the feathers under the wing
subaperio -- to open from within
subigo -- to drive up, bring up, drive up stream, To turn up from beneath, break up, dig up, plough, cultivate, work, knead, rub down, sharpen, whet, tame, break, easy to be tamed, to put down, overcome, conquer, subjugate, subject, subdue, reduce, To bring, incite, impel, force, compel, constrain, reduce, to cultivate, train, discipline
subarro -- -tr. - Cass. engager par des arrhes, hypothéquer.
subasso -- to roast a little
subauro -- leicht vergolden
subaresco -- se dessécher un peu.
subaro -- to plough close to
__supere__*
supereffulgeo -- to be more than effulgent
supereffero -- to exalt, extol
superegredior -- to surmount
supereffluo -- to superabound, be superfluous
superemorior -- to die upon
supererogo -- to spend, pay out over and above
supereuolo -- to fly away over
supereleuo -- to raise above
superedo -- to eat besides, after#
__anim__
animaduerto -- to direct the mind, give attention to, attend to, consider, regard, observe, to call attention to the consul's presence, To mark, notice, observe, perceive, see, discern, whatever attention or consideration be given, the fact observed by. &mdash; To attend to, censure, blame, chastise, punish, deserves to be punished, worthy of punishment, there is nothing censurable
animaduorto -- to direct the mind, attention, to attend to, give heed to, to take heed, consider, regard, observe.
animula -- a breeze.&mdash;A bit of life
anima -- air, a current of air, breeze, breath, wind, the air, Breath, take breath, correct their breath, the fumes of wine, life, to give up the ghost, exert yourself in gesturing to the point of death, is in debt for his life?, for everything, A life, living being, soul, person, The shades, departed spirits, manes, The rational soul, mind
animo -- to enliven, quicken, animate / to dispose, inspirit, are inspirited
animus -- the rational soul, soul, life, the mental powers, intelligence, reason, intellect, mind, attention, whose discernment, the whole intelligence of the community, Of the memory, Consciousness, recollection, self-possession, the conscience, Opinion, judgment, notion, belief, in my judgment, to the best of your knowledge and belief. &mdash; The imagination, fancy, Feeling, sensibility, affection, inclination, passion, heart, the character, bad mind, bad heart, Disposition, inclination, well disposed, both gold and the disposition, to give it, a kindly disposition, from the heart, in earnest, deeply, sincerely, from impulse or with some design, adjj., pitying him in her heart, disposition, character, temper, wild nature, Courage, spirit, to be of good courage, courage enough, hope, the violence, give it quicker motion, Haughtiness, arrogance, pride, your pride is roused, bear the arrogance and pride, Passion, vehemence, wrath, an even mind, calmness, moderation, equanimity, with even mind, contentedly, resignedly, patiently, is content to believe, Inclination, pleasure, for the sake of amusement, for diversion, for pleasure, employ musicians.&mdash;Will, desire, purpose, design, intention, resolve, purpose, to intend, my plan is, it was my purpose
animesco -- int., s'animer, s'irriter
__consur__
consurgo -- to rise, stand up, arise, start up, rise in a body, lift oneself
__exper__
experimentum -- a proof, test, trial, experiment, Experience
experimento -- - tr. - expérimenter.
expergiscor -- to be awakened, awake, To awake, be alert, bestir oneself
experiscor -- - tr. - Inscr. éprouver.
experiuro -- jurer fortement.
expergo -- to awaken, rouse up
experior -- to try, prove, test, experience, endure, seek to win back, might have a full trial, may find, to have tried, have learned, have experienced, know by experience, To measure strength with, contend with, To try, undertake, attempt, make trial, undergo, experience, resort to everything before using, the last resort, find, submit to, To try by law, go to law, submit to trial
expergisco -- c. expergiscor.
__reprae__
repraesento -- to make present, set in view, show, exhibit, display, manifest, represent, depict
repraesto -- tr., présenter, fournir
repraendo -- to hold back, hold fast, take hold of, seize, catch.
__exsuper__
exsuperantia -- preeminence, superiority
exsupero -- to mount up, tower
exsupera -- sorte de verveine
__aco__
acoenonoetus -- without common-sense, Iu.
acoenonetus -- 
acolythus -- acolyte (clerc qui sert le prêtre à l'autel).
acoetum -- miel vierge.
acorna -- a kind of thistle
acopum -- a soothing salve
__addi__
additamentum -- an accession, reinforcement
addiuino -- to divine, to prognosticate
addico -- to give assent.
addo -- to put to, place upon, lay on, join, attach, appear as a candidate, lay me too in my brother's tomb, confer, a blight falls, to bring to, add to, to give courage, embolden, impart, bestow, puts on, apply the spur, to add by way of increase, join, annex, give a further respite, if you say another word, increase the poor man's little, will name Lu. too, giving also the night to the work, adds one to their number, confounds with, involve you also in, gives more work, make much of, was sixteen years old, make essential additions to, add course to course, outdo themselves, add to this, consider also, remember too, moreover ...
__adin__
adintellego -- - tr. - comprendre avec.
adinuestigo -- - tr. - chercher avec soin. rechercher.
adingero -- to bring to in addition, to heap on
adingredior -- - tr. - pénétrer dans, prendre possession de qqch.$
adinquiro -- to investigate, inquire into further$
adinsurgo -- v. adsurgo.$
adinuenio -- to find out, to devise, adinventus
adinuentum -- an invention
adindo -- to put in besides
adinuoluo -- 
adincresco -- to increase
adinflo -- to swell up$
__aem__
aemulamentum -- Ps. Tert. rivalité.
__ama__
amasiuncula -- amante.
amasiunculus -- a fond lover
amatorculus -- a little, sorry lover
amaracinum -- marjoram ointment
amalusta -- camomille.
amarantus -- the amaranth
amalocia -- Apul. camomille.
amaracum -- marjoram
amaracus -- marjoram:
amaritia -- Gloss. amertume.
amarities -- bitterness:
amarizo -- - intr. - devenir amer.
amatorium -- a means of exciting love, a philter
amaturio -- verb. desid., to wish to love
amasco -- to begin to love
amaresco -- - intr. - Aug. devenir amer, s'aigrir.
amaro -- - tr. - Avien. rendre amer.
amasius -- a lover
amatus -- P. of amo.
__ame__
amethystina -- vêtements couleur d'améthyste.
amethystus -- The amethyst, a precious stone of violet-blue color
amellus -- purple Italian starwort, V.
amella -- 
__anab__
anabaptismus -- a second baptism
anabolicarius -- Ulp. celui qui importe des marchandises par mer, importateur.
anabaptista -- anabaptiste (hérétique qui donnait un deuxième baptême).
anabathmus -- marche, degré (par où les furies montaient sur le théâtre).
anabathrum -- an elevated place for beholding public games, tiers of benches that rest on hired beams
anabathra -- raised seats (in a theatre), Iu.
anaboladium -- Isid. écharpe.
anabasius -- courrier, messager.
anabolium -- a surgical instrument
__anteco__
antecolumnium -- emplacement devant des colonnes
__are__
arenifodina -- a sand-pit
arenaria -- carrière de sable, sablière.
arenarium -- carrière de sable, sablière.
arenatum -- mortier, mélange de chaux et de sable.
arenosum -- terrain sablonneux.
areola -- A small, open place
aresco -- to become dry, dry up
arena -- sand, grains of sand; sandy land or desert; seashore; arena, place of contest;
__circumpur__
circumpurgo -- to cleanse, purify around
__coa__
coassamentum -- assemblage de planches, plancher, parquet
coagmentarius -- joining together
coarticulo -- to cause to articulate
coassumo -- to assume together
coapostata -- der Mitabtrünnige
coaegroto -- to be sick at the same time with
coaestimo -- to estimate together with
coagmento -- to join, cement together, connect, to connect, to conclude
coagmentum -- a joining together, joint
coagulare -- the colon
coaltercor -- int., avoir une discussion avec
coappello -- tr., appeler avec ou en même temps$
coascendo -- int., monter avec$
coattestor -- attester ensemble$
coarguo -- to overwhelm with proof, refute, silence, expose, convict, prove guilty, To prove, demonstrate, show, establish, expose, refute, has proved injudicious, betrays
coaccedo -- to come to, be added besides
coactarius -- fabricant de feutre
coactilia -- thick, fulled cloth, felt
coactura -- récolte, cueillette.
coaetaneo -- to be of the same age
coaggero -- - tr. - couvrir d'un amas.$
coalumna -- camarade d'enfance
coaceruo -- to heap together, heap up, collect in a mass, to amass, to multiply, heap
coadoro -- to worship, adore along with
coaegresco -- to become sick at the same time with
coagito -- to shake together
coagulo -- to cause a fluid to curdle, coagulate
coagulum -- an agent of coagulation, rennet, runnet, Curds
coarcto -- to press together, compress, contract, confine
coaequo -- to make equal, make even, level, to equalize, drag down
coarto -- to press together, compress, contract, confine, to abridge, shorten, to abridge, compress
cogo -- to drive together, collect, crowd, bring together, summon, congregate, convene, collected, to exact, to extort, levy, to convene, to be summoned, to thicken, condense, curdle, coagulate, gather, To contract, narrow, straiten, To force, drive, press, to bring up the rear, are the last, my resources are brought into straits, restrict. &mdash; To urge, force, compel, constrain, are rolled up tightly, spontaneously, forced, uncontrollable, on compulsion, To conclude
coacta -- felted cloths
coacto -- to constrain, force
coaeto -- - intr. - Tert. être du même âge.
coapto -- to fit, join, adjust together with something
coarmius -- compagnon d'armes
coarmo -- to arm together
coasso -- to join boards, planks together
coalesco -- to grow firmly, strike root, increase, become strong, had sprung up, to unite, agree together, coalesce, be adjusted, becoming established, recovering strength, fostered
coalo -- to sustain, nourish together with
coacesco -- to become acid, sour, to deteriorate, become corrupt
coaresco -- to dry, become dry together
coareo -- int., sécher ensemble
coaxo -- to croak
__compro__
compromissum -- an agreement to abide by the award of an arbiter$
compromitto -- to agree to abide by the award of an arbiter.$
compropheta -- confrère en prophétie
compropinquo -- int., s'approcher ensemble
compropero -- int., se hâter ensemble
comprobo -- to approve, assent to, sanction, acknowledge:
__conde__
condescendo -- to stoop, let one's self down, to condescend$
condescensus -- condescendance$
condecentia -- convenance, bienséance, décence.
condecerno -- to decide, determine together, med.$
condeclino -- to decline in the same manner
condelector -- to be delighted with something
condeliquesco -- to melt wholly, completely, to dissolve
condecoro -- to grace, applaud, honor:
condemno -- to convict, condemn, sentence, find guilty, for his own benefit, in an arbitration on the partnership, capitally, be mulcted, To condemn, blame, disapprove, to convict, prosecute successfully, prove guilty
condenseo -- to make very dense, to condense, to press close together
condenso -- - tr. - rendre compact, condenser, épaissir; serrer, grouper.
condepso -- to knead together
condeceo -- it is fitting/becoming/seemly/meet; (w/ACC + INF);
condecet -- it becomes, it is becoming, meet, seemly
__conse__
consequentia -- a consequence, natural succession
consectaria -- conclusions, inferences
consentanea -- it agrees with something, it is according to reason, fitting, consistent, proper
consepelio -- to bury with
consermonor -- to converse with one, to talk
conseruitium -- joint servitude
conseruula -- a small (female) fellow-slave
conseruulus -- compagnon d'esclavage.
consequor -- to follow, follow up, press upon, go after, attend, accompany, pursue
consemino -- - tr. - engendrer avec.
consecro -- to dedicate, devote, offer as sacred, consecrate, To honor as a deity, place among gods, deify, glorify, consign, immortalize, To doom to destruction, devote, make accursed, execrate, To surrender, to the vengeance of, to devote, attach devotedly, ascribe as sacred, To make immortal, immortalize
consecror -- c. consecro
consentio -- to agree, accord, harmonize, assert unitedly, determine in common, decree, unite upon:
consensus -- agreement, accordance, unanimity, concord, as you all agree, unanimously, beset with demands for, has become a general custom, with one accord, A plot, conspiracy, Agreement, harmony
consentes -- consentes dii : the twelve superior deities
consentium -- a council
consequia -- consequence; retinue; rear guard;
consido -- to sit down, take seats, be seated, settle
consessus -- a collection, assembly
consero -- to connect, entwine, tie, join, fit, bind, unite, pinned together, To join, bring together, manum, manūs, manu, to fight hand to hand, join battle, I summon you to a trial face to face, pugnam or proelium, was grappled, employed in fight
conseco -- to cut to pieces, cut up
consecto -- c. consector.
consector -- to follow eagerly, attend continually, go after:
consepio -- to fence round, hedge in
consepto -- to fence round, hedge in, enclose
conseptum -- enclos, enceinte, parc.
consenesco -- to grow old together, grow old, become gray
conseruo -- to retain, keep safe, maintain, preserve, spare
conserua -- a (female) fellow slave
__dea__
deargumentor -- to decide finally
dealbamentum -- die Übertünchung
deargento -- To deprive of money
dearmo -- to disarm; to deprive of power; to blunt;
dealbo -- to whiten, whitewash, plaster
deartuo -- to dismember, to rend limb by limb;, to ruin
deascio -- to hew, cut with an axe, to smoothe
deauro -- to gild, to gild over, no.
__deprae__
depraesento -- tr., payer comptant, argent comptant
depraedor -- act., to plunder, pillage, ravage, pass.
depraedo -- tr., c. depraedor / part. à sens passif
__diab__
diabathrarius -- the maker of a sort of slipper, a shoemaker
diabathrum -- a sort of slipper
__diad__
diadictamnum -- remède à base de dictame
diadota -- a distributor
__disco__
discooperio -- to uncover, disclose, lay bare, expose
discophorus -- one who carries a dish, a dishbearer
discobino -- to file away, to scratch, destroy by scratching
discordo -- to be at variance, differ, quarrel, to be unlike, be opposed, protests, To mutiny
discordia -- disunion, disagreement, dissension, variance, discord, inconsistency, the subject of strife, Mutiny, rebellion, the goddess of discord
discordium -- discord, dissension.&mdash;Plur.
discoquo -- to boil to pieces, to boil thoroughly
discorio -- Gloss. ôter la peau.
__excom__
excommunico -- to lay under the ban of the Church, to excommunicate
excomedo -- to eat up, consume
__interam__
interamenta -- the interior woodwork
__intere__
interequito -- to ride between
intererro -- to wander between, among, to come, go, be between
__intero__
interordinium -- the space between two rows
__maledi__
maledicentia -- an evil-speaking, abuse, scurrilousness
maledictito -- to revile, abuse vehemently, repeatedly
maledico -- to speak ill of, abuse, revile, slander, asperse
maledictum -- a foul saying, abusive word
__perco__
percognosco -- to become perfectly acquainted with$
percooperio -- to cover entirely$
percolapho -- to buffet well
percolopo -- to box the ears, to beat
percoquo -- to ripen
percoeno -- - intr. - achever de dîner. (Lebaigue P. 913)
percolo -- to strain through, to filter, percolate.
__perde__
perdescribo -- - tr. - Grom. décrire exactement, décrire en détail.
perdecipio -- to deceive utterly
perdefleo -- to lament$
perdepso -- to knead, work over
perdeleo -- to destroy utterly, to exterminate
__peren__
perenniseruus -- one who is always a slave
perennito -- lange erhalten
perenno -- to last, endure, be permanent
__persub__
persubhorresco -- Sisen. se hérisser fortement (en parl. de la mer).$
__praecom__
praecommodo -- to advance as a loan, to give as a favor
__praeo__
praeostendo -- to show beforehand, display before, make clear, Absol.
praeoccupo -- to seize upon beforehand, preoccupy
praeordino -- to preordain
praeoccido -- to go down, set before$
praeopinor -- penser d'avance.
praeoriga -- per ou prae, auriga), intendant d'un haras [ou] palefrenier
praeopto -- to choose rather, desire more, prefer
praeoleo -- to emit, exhale an odor beforehand
praeolo -- to perceive before
__praepro__
praepropero -- to hasten greatly
__praetera__
praeterago -- to drive by, drive past
__prode__
prodeambulo -- to walk abroad
prodigo -- to squander, waste
__proo__
prooeconomia -- a previous arrangement
prooemium -- an introduction, preface, proem
prooemior -- to make an introduction, preface
__subde__
subdescendo -- to descend lower$
subdefendo -- - tr. - défendre quelque peu.
subdealbo -- to whiten a little, make whilish$
subdeligo -- to choose
__superamb__
superambulo -- to walk upon, over
__superam__
superamentum -- a remainder, remnant
__superi__
superilligo -- to bind over, upon$
superillino -- I. To smear over, besmear, anoint with a thing II. To smear or spread a thing over another$
superirruo -- to fall in upon, over$
__superinter__
superintero -- - tr. - Th.-Prisc. frotter sur.
__supero__
superoccido -- - intr. - Macr. se coucher après (en parl. de la lune).$
superoccupo -- to take by surprise, take unawares
superordino -- to appoint in addition, to add something to
superoperio -- to cover over
__superse__
supersemino -- to, sow upon, over, med.
supersedeo -- to sit upon; hence, fig., to be superior to, forbear, refrain, desist, leave off, pass, omit
supersellium -- a shabrack
supersero -- to sow over, upon, to sow in addition
__transad__
transadigo -- to thrust through, drive through, To pierce through
__transsu__
transsumo -- to take, to adopt, assume
transsulto -- to leap over, across
transsuo -- to sew, stitch through; to pierce through
__absin__
absinthiatum -- wormwood-wine
absinthium -- absinthe (plante amère).
absinthius -- wormwood
__circumsur__
circumsurgo -- sich ringsum erheben
__coin__
cointellego -- tr., comprendre en même temps
coinquino -- to pollute, contaminate:
coinfero -- - tr. - apporter ensemble.$
coinquio -- to cut off, cut down
coinquo -- tr., émonder [des arbres sacrés]
__consu__
consultantes -- they who seek advice;, clients
consulentia -- prévoyance, prudence, sagesse.
consultatum -- a resolution, decision
consusurro -- to whisper together
consumo -- to use up, eat, devour
consummo -- to accomplish, complete, finish, perfect, an intercalary day, the glory of finishing
consuadeo -- to advise, counsel strongly
consuauio -- to kiss much, affectionately
consuauior -- to kiss much, affectionately
consulo -- to meet and consider, reflect, deliberate, take counsel, consult, take care, have regard, look out, be mindful, to take thought for the future, for the common good, ne, To take a resolution, resolve, conclude, determine, To consult, inquire of, ask for advice, counsel with, apply to, question, asked, ask your opinion of it. &mdash; Supin. acc., To consult, To take counsel, ask advice, skilled in the law, To refer to, consult, To deliberate upon, consider, To advise, counsel, recommend, To resolve upon, determine, decide, commit suicide, to regard favorably, take in good part
consuleo -- Fort. c. consulo.
consuo -- to sew together/up, stitch/join; to make by sewing together; to patch up; to devise, plan;
consutum -- vêtement cousu.
consudasco -- to sweat much;
consudesco -- to sweat much;
consudo -- to sweat much, profusely
consuesco -- to accustom, inure, habituate
__decom__
decomposita -- verbes dérivés (de verbes composés).
__die__
diecrastini -- v. crastinus.
diephebus -- celui qui a passé l'adolescence
diecula -- a little while, respite
__edi__
editiuncula -- dim. de editio
edico -- Of a magistrate or officer, to declare, publish, make known, proclaim, order, establish, decree, ordain
edictum -- a proclamation, ordinance, edict, manifesto, an edict, inaugural address, learned in the law as defined by successive praetors, An order, command
edicto -- to speak out, proclaim, publish
__inse__
insensibilia -- things of no account
insequor -- to follow, follow after, come next
insectura -- an incision
inseruio -- to be serviceable, be devoted, be submissive, serve
insemino -- to sow, plant in, to implant
inserpo -- to crcep on, over
insideo -- to sit upon, settle on, to take place, settle, be fixed, adhere, To take possession of, occupy, inhabit
insido -- to sit in, settle on
insecta -- Plin. insectes.
insecto -- to pursue, pass., pursued
insector -- to pursue, follow up, extirpate, to pursue, attack, rail at, inveigh against, lecture
insectum -- an insect; plur.
inseco -- to cut into, cut up
inserta -- an ornament
inserto -- to put in, insert
insequo -- dire, raconter; chanter.
insero -- to implant, ingraft
inseruo -- To attend to, observe
insenesco -- to grow old in, spend a life upon
__percon__
perconterreo -- tr., frapper de terreur
percontor -- to ask particularly, question strictly, inquire, interrogate, investigate, of her too he wished to ask some questions
percontatum -- a fundamental truth, an established principle
perconto -- to question strictly, particularly, to inquire earnestly
perconor -- to carry out
__postde__
postdelictum -- délit postérieur, récidive
__praepost__
praepostero -- to reverse, invert
__abscon__
abscondo -- to put out of sight, hide, conceal:
__circumde__
circumdo -- to place around, cause to surround, set around:
__circumsed__
circumsedeo -- to sit around, surround, besiege, blockade, invest, encompass, beset:
circumsideo -- to sit around a person or thing, to surround.
__disper__
dispertio -- to distribute, divide, assign, to divide, apportion, distracted
dispercutio -- to dash out
disperdo -- to spoil, ruin
dispergo -- to scatter, spread abroad, disperse, P. perf., scattered, straggling, To besprinkle, bespatter, to scatter, conduct without order, disperse, without organization, To spread abroad
dispertior -- to distribute, apportion, refine
disperno -- to despise
__emo__
emolumentum -- gain, profit, advantage, benefit
emolimentum -- derate
emollio -- to make soft, soften
emoderor -- to moderate
emodulor -- to sing, celebrate
emolior -- to move out, bring out by effort
emolo -- to grind up.
emorior -- to die off, die, decease
emollesco -- - intr. - devenir mou, s'amollir.
emoueo -- to move out, move away, remove, expel, dislodge
emola -- c. amula
emoneo -- to admonish
__insur__
insurgo -- to rise up, rise, lift oneself
__interem__
interimo -- to take from the midst, take away, do away with, abolish, To destroy, slay, kill, To distress intolerably, afflict
__obse__
obsequentia -- complaisance, obsequiousness
obsecundo -- to comply, humor, yield, be accommodating
obsequela -- compliance, complaisance, obsequiousness, through obsequiousness in speaking, because they spoke as he liked
obseruito -- to watch carefully, observe closely
obsequor -- to comply, yield, gratify, humor, submit, be accommodating
obsecula -- femme de moeurs faciles
obsequium -- compliance, yieldingness, complaisance, indulgence, gluttony, to her lover, by its pliancy, Obedience, allegiance
obsequiae -- funeral rites, obsequies
obsideo -- to sit, stay, remain, abide, To beset, haunt, frequent, to hem in, beset, besiege, invest, blockade, hampered in every way, Supin. acc., choked, To occupy, fill, possess, is filled, surrounded, take up, besieged, To watch closely, look out for
obsido -- to beset, invest, besiege, blockade
obsepio -- to hedge, fence in, to enclose;, to close up, to render impassable, inaccessible
obseruo -- to watch, note, heed, observe, take notice of, attend to
obsero -- to bolt, bar, fasten, shut up
__reco__
recognosco -- to know again, recollect, recall to mind, recognize$
recolligo -- to recover, gather again, collect$
recogitatus -- thought, reflection
recordantia -- souvenir
recorrigo -- to mend, correct again
recolloco -- to lay back again, replace
recorporo -- to furnish again with a body, to restore the body to, its former condition, med.
recogito -- to think over, reconsider
recordor -- to think over, bethink oneself of, be mindful of, call to mind, remember, recollect, lay to heart
recordo -- tr., faire ressouvenir, rappeler au souvenir
recoquo -- to boil again, renew by boiling
recolo -- to till again, cultivate anew, work over
recogo -- to collect again
__redin__
redintegro -- to make whole again, restore, renew, recruit, refresh
redinuenio -- to find again
__reper__
repercutio -- to strike back, drive back; only late in act, P. pass., thrown back, rebounding
repertorium -- an inventory, catalogue, repertory
reperio -- to find again, find, meet with, find out, discover, grieved me less when lost than when found, to find, find out, discern, get, procure, obtain, save themselves, To find, discover, perceive, learn, ascertain, were found to be, To find out, hit upon, invent, devise, discover, devices for gain
reperta -- découvertes, inventions
reperco -- to be sparing with, to spare, to refrain, abstain from, if they in no way refrain from doing, believing, this
__repre__
reprehendo -- to hold back, hold fast, take hold of, seize, catch
reprehenso -- to check continually
reprimo -- to press back, keep back, check, curb, restrain, hem in, driven back, to check, curb, restrain, limit, confine, repress, suppressed, refrain, will control myself
reprendo -- to hold back, hold fast, take hold of, seize, catch.
__resur__
resurgo -- to rise again, appear again, lift onself
__transpor__
transporto -- to carry over, take across, carry, convey, remove, transport
__adsur__
adsurgo -- to rise up, rise, stand up:
__exsur__
exsurgo -- to rise up, rise, get up, stand up
exsurdo -- to deafen, dull, blunt
__ada__
adauunculus -- oncle au quatrième degré.
adagnosco -- Tert. reconnaître.
adaggero -- to heap up, brought down, deposited by the Nile
adalligo -- to bind to, to fasten to, to attach
adaperio -- to throw open, open wide, lay open:
adaestuo -- to rush, to roar, boiling up
adaucto -- to augment much
adaugeo -- to increase by adding, augment:
adareseo -- int., sécher, devenir sec
adaequo -- to make equal, equalize, level with:
adapto -- to adjust, modify; to fit (to) (w/DAT);
adigo -- to drive, urge, bring by force, take, compelled to come before an arbiter, to ram in, to drive home, plunge, thrust, reach its mark, inflicted, to drive, urge, force, compel, bring, pressed, brought into the form of a ship, to put on oath, bind by oath, cause to take an oath, swear, takes the oath under compulsion
adaero -- to estimate by money, to rate, appraise, value
adarca -- Plin. Veg. écume salée (qui s'attache aux herbes des marais).
adarmo -- - tr. - facund. armer.
adaudio -- - tr. - Schol. Pers. ajouter par la pensée.
adaugesco -- to grow, increase
adarto -- resserrer
adagium -- a proverb, an adage
adaquo -- to bring water to, to give to drink, pass., to be brought to drink
adaquor -- to obtain water, fetch water (once):
adaresco -- to dry up
adaro -- to plough carefully
adasia -- P. Fest. vieille brebis qui vient de mettre bas.
adauia -- aïeule au quatrième degré.
adauus -- aïeul au quatrième degré.
__amo__
amolimentum -- Gloss. amulette.
amolior -- to remove, move away, take yourselves off, to avert, put away, remove, put out of consideration
amoeno -- to make pleasant, med.
amoena -- pleasant places
amolo -- mêler avec de l'amidon
amolum -- amidon, empois
amomum -- an aromatic shrub, used in making balsarn:
amoueo -- to move away, take away, remove, reflex., to take oneself off, retire, withdraw, To get away, abstract, steal, To remove by banishment, banish, to lay aside, set aside, get rid of, jesting apart, avert
__anteo__
anteoccupo -- - tr. - anticiper, prévenir.
__aper__
apertularius -- - 1 - Gloss. celui qui ouvre avec effraction. - 2 - Gloss. concierge.
apertura -- An opening
aperio -- to uncover, lay bare, with bared breast, with his throat cut, bring to light, with bared breasts, To open, uncover, unclose, make visible, discover, display, show, reveal, as an asylum, discloses, comes in sight, while the fleet was still hidden behind them, for the utterance of, to begin, to cleave, to lay open, render accessible, to disclose, unveil, reveal, make known, unfold, explain, expose, to disclose the future, show what they are, betray himself
__apost__
apostatatus -- Greg. apostasie.
apostolatus -- the office of an apostle, apostleship
apostasia -- a departure from one's religion, apostasy
apostola -- Aug. femme apôtre.
apostolus -- a notice sent to a higher tribunal, judge
apostoli -- lettre qui renvoie une cause à une juridiction supérieure
apostema -- apostume, abcès
__beneo__
beneolentia -- a smelling agreeably
__circumob__
circumobruo -- to cover around with, wrap around
__coex__
coexercito -- tr., exercer simultanément
coexsisto -- int., coexister
coexsulto -- - intr. - se réjouir avec.
coextendo -- étendre jusqu'à, juger capable
coexcito -- tr., réveiller ensemble
coexsulo -- int., s'exiler en même temps
__compost__
compositura -- a joining together, connection
compostile -- sorte de boîte à compartiments servant à entreposer des plats, des assiettes.
__conco__
concorporo -- to unite in one body, to incorporate
concolligo -- tr., recueillir, rassembler$
concolona -- she who inhabits the same town, house with one, a female fellow-citizen, fellow-inhabitant
concopulo -- to join, unite
concogito -- tr., avoir dans la pensée
concordia -- an agreeing together, union, harmony, concord, a beautiful friendship, likeness in difference, the goddess of Concord
concordo -- to agree, be united, be of one mind, harmonize, to be consistent, be in harmony, agree
concoquo -- to digest:
concolo -- tr., honorer ensemble
__consub__
consubsido -- - intr. - Minuc. rester (au milieu d'un groupe).$
consubigo -- to work, knead, mix together, med.
__desur__
desurgo -- to rise from, to rise
__exad__
exaduocatus -- one who has been an advocate, an ex-advocate
exadytuo -- écarter d'un temple
__exo__
exopinisso -- to think
exorcismus -- exorcism;
exorcista -- exorcist; cleric of minor orders (second level from top/deacon);
exorabula -- means of entreating, convincing, enticements, arguments
exoratorium -- moyen propre à fléchir
exorcizo -- to exorcise;
exoccupo -- to discharge of employment, free from occupation
exochadium -- external piles
exocoetus -- a fish that sleeps on the shore
exodiarius -- a player in the
exorbito -- - 1 - intr. - dévier, s'écarter, s'éloigner. - 2 - tr. - faire dévier.
exorciso -- - tr. - exorciser, chasser (les démons).
exonero -- to free, disburden, unload, empty
exoculo -- to deprive of the eyes, sight
exostra -- a movable stage (in the theatre)
exoticum -- vêtement exotique
exopto -- to wish earnestly, desire greatly, long for
exordior -- to begin a web, lay the warp, prepare to weave
exorsa -- a beginning, commencement, preamble
exordium -- the warp of a web, a beginning, commencement, origin, An introduction, exordium, proem, preface
exorior -- to come out, come forth, spring up, rise, appear
exortus -- a coming forth, rising
exorno -- to fit out, equip, furnish, supply, provide
exosso -- to deprive of bones, bone
exodium -- an after-play, farce
exolesco -- to grow out of use, become obsolete, pass away, cease
exoleo -- - intr. - cesser de croître.
__expor__
exporgo -- étendre, déployer, allonger.
exporrigo -- to spread out
exporto -- to carry out, bring out, convey away, send away, export
__expro__
expromitto -- to promise, agree to pay$
expromo -- to show forth, discover, exert, practise, exhibit, display
exprompto -- fréq. de expromo
expropitio -- rendre propice
exprobro -- to reproach with, blame for, find fault, charge, upbraid, reproach, throw the blame of
__exsu__
exsultantia -- a springing up, an attack
exsuppuro -- - 1 - faire suppurer. - 2 - au fig. Tert. faire sortir (qqch de vicié).
exsuscito -- to rouse from sleep, awaken
exsufflo -- To blow away
exsulatus -- banishment, exile
exsumptuo -- - tr. - Gloss. rendre pauvre.
exsucco -- to deprive of juice, extract the juice of
exsugo -- OR
exsuco -- to deprive of juice, extract the juice of
exsudo -- to ooze, exude
exsugeo -- c. exsugo.
__ima__
imaguncula -- a little image
imaginor -- to picture to oneself, fancy
imagino -- to give an image of, to represent, fashion
__ine__
inefficacia -- inefficacy
inelegantia -- tastelessness, inelegance;, want of harmony, inconsistency, t.
inerticula -- sorte de vigne, qui donne un bon vin, mais un vin qui ne grise pas.
inescatorium -- amorce, appât.
ineptiola -- an absurdity, folly
inequito -- to ride upon, over
inerratum -- absence d'erreur, opposé de l'erreur.
inemorior -- to die upon
ineptio -- to be absurd, trifle, play the fool
ineptiae -- sillinesses, fooleries, trifles, absurdities
inerro -- to wander, err
inertia -- want of art, unskilfulness, ignorance, rudeness, Inactivity, idleness, laziness, aversion to
inebrio -- to make drunk, intoxicate
inermo -- - tr. - désarmer.
inesco -- to allure with bait, entice, to entice, deceive
inedia -- an abstaining from food, fasting
inigo -- To drive into, to, to drive
__ino__
inordinatum -- désordre, confusion.
inopinatum -- 
inordino -- to arrange, bring into order
inoculo -- to inoculate, to ingraft an eye, bud of one tree into another
inodoro -- to scent, cause to smell
inodoror -- to smell out, trace out
inopaco -- to overshadow
inopero -- to effect, produce
inoperor -- to effect, operate, produce
inopinor -- to suppose, think, opine
inocco -- to harrow in
inorno -- to adorn
inopia -- want, lack, scarcity, Want, need, indigence, poverty, scarcity, famine, by keeping unsatisfied, A scant supply, scarcity, Want, helplessness, embarrassment, the unprotected, poverty, barrenness
inolesco -- to grow, grow upon
__intera__
interaestuo -- to bubble up, at intervals, to be restless
interaperio -- - tr. - entrouvrir.
interaresco -- to become dry, dry up, decay
__interpur__
interpurgo -- to cleanse here and there
__interre__
interregnum -- an interval between two reigns, interregnum
__interse__
intersaepio -- to fence about, hedge in, stop up, enclose, secure
interseco -- to cut asunder, separate, divide, intersect
intersero -- to place between, interpose, add
__intertra__
intertraho -- to take away, withdraw from
__intropor__
introporto -- to bring in
__oba__
obaudientia -- obedience
obacerbo -- - tr. - Fest. exaspérer.
obaemulor -- to stir up, irritate, provoke
obauditus -- a listening
obacero -- to contradict, interrupt
obagito -- Enn. harceler, pousser devant soi.
obardesco -- to burn before, to blaze out
obarmo -- to arm
obatresco -- to become black
obaudio -- to obey, absol.
obaresco -- to grow dry, to dry up
obaro -- to plough around, plough up
__pera__
peraestimo -- to esteem greatly
peragito -- to drive, hunt about greatly, to harass, disturb
peraticum -- a species of the bdellium-tree
perago -- to thrust through, pierce through, transfix
peragro -- to wander through, travel, pass through, traverse, to go through, traverse, spread, search, penetrate
peragror -- 
peraequo -- to make quite equal, filled up, yielded, produced
perardeo -- to burn violently
perarmo -- to arm, equip well
peracesco -- to become sour through and through, thoroughly sour;, to become vexed, to grow vexatious
peraresco -- to grow very dry
peraro -- to plough through, furrow
__perex__
perexcrucio -- - tr. - tourmenter cruellement.$
perextimeo -- tr., craindre fort vivement$
perextimesco -- to fear greatly
__praeamb__
praeambulo -- to walk before
__prodamb__
prodambulo -- - intr. - Ter. sortir pour se promener.
__prodi__
prodigentia -- extravagance, profusion, prodigality
__proper__
properantia -- a hastening, haste
__reda__
redaccendo -- to kindle again, rekindle
redauspico -- to take the auspices anew, again
redarguo -- to disprove, refute, confute, contradict
redigo -- to drive back, force back, lead back, bring back, to bring back, force back, recall, coerced, To get together, call in, collect, raise, receive, take up, paid into the public treasury, to reduce, bring down, diminish, To bring down, bring, reduce, force, compel, subdue, bring down, reduce to a province, reduce to poverty, render empty and useless, had made it certain, two acc., to make, render, cause to be
redardesco -- to blaze up anew
redarmo -- tr., armer de nouveau
__redem__
redemptito -- to buy up, redeem, to compensate, make amends for
redemptura -- an undertaking by contract, contracting, farming
redimo -- to buy back, repurchase, redeem, To ransom, release, redeem, ransomed at the public cost, To buy off, set free, release, rescue, To buy up, obtain by purchase, take by contract, undertake, hire, farm, secure by bribery, undertake, to buy, purchase, redeem, secure, gain, acquire, obtain, procure, To buy off, ward off, obviate, avert, To pay for, make amends for, atone for, compensate for
redempto -- to ransom, redeem
__redim__
redimiculo -- - tr. - détacher, ôter une attache.
redimicula -- a band.
redimio -- to bind round, wreathe round, encircle, gird, wind, deck, crown
redimo -- to buy back, repurchase, redeem, To ransom, release, redeem, ransomed at the public cost, To buy off, set free, release, rescue, To buy up, obtain by purchase, take by contract, undertake, hire, farm, secure by bribery, undertake, to buy, purchase, redeem, secure, gain, acquire, obtain, procure, To buy off, ward off, obviate, avert, To pay for, make amends for, atone for, compensate for
redimiae -- rançon.
__repro__
repromitto -- to promise in return, to engage, bind one's self
repropitio -- to propitiate again, make propitiation for
reprobo -- to disapprove, reject, condemn
__subo__
suboffendo -- to give some offence
subostendo -- to point out secretly, to show indirectly, med.
suborno -- to fit out, furnish, provide, supply, equip
subortus -- a rising, springing up
suboleo -- to emit a trifling smell.&mdash; With
subolesco -- to grow up
subolo -- to be perceived, be suspected
__subre__
subrectito -- to rise up, arise
subrelinquo -- Aug. laisser après soi.
subremaneo -- to remain behind
subregulus -- a petty prince, a feudatory vassal
subremigo -- to row gently
subresono -- int., se faire entendre
subrepo -- to creep under, steal into
subripio -- to snatch away, take secretly, withdraw privily, steal, pilfer, purloin, plagiarized, could be rescued by trickery
subreptum -- 
subrigo -- to erect, make rigid, straighten up, directed upwards
surrigo -- I. Act., to lift or raise up, to raise, erect, elevate II. Neutr., to rise, arise, to get up, stand up
subrego -- tr., gouverner [en second]
__subse__
subseliarium -- place des magistrats au théâtre
subsequor -- to follow after, follow up, succeed, ensue
subsellium -- a low bench, seat, form, a senator's seat, of the accused, A judge's seat, the bench, a court, tribunal, a lawyer in the courts, as judge and advocate
subseco -- to cut under, cut away below, clip, pare
subsentio -- to observe stealthily, spy out
subsessa -- an ambush, ambuscade, med.
subsido -- to sit down, crouch down, squat, settle down, sink down
subsequium -- the sequel, what follows after
subseruio -- to serve, come to the help of, aid
subsero -- to sow, plant after
__subterse__
subterseco -- to cut, divide, separate underneath
__suco__
sucophanta -- horn
sucophantia -- craft, cunning, deceit; sing., Plur.
sucophantor -- to play the rogue, to deceive, trick, cheat
__superen__
superenato -- to swim over
__supertra__
supertraho -- to draw over
__surre__
surrectito -- to rise up, arise
surregulus -- a petty prince, a feudatory vassal
surremigo -- to row underneath, to row along
surremaneo -- to remain behind, med.
surgo -- to rise, arise, get up, stand up, to rise, arise, take the floor, to break up, march, To rise, arise, leave one's bed, awaken, To go up, rise, mount up, ascend, into life, towering, stands, To rise, spring up, grow up, be built, growing, to rise, arise, occur, swell, To rise to, rise against, attempt, attack
subrigo -- to erect, make rigid, straighten up, directed upwards
surrigo -- I. Act., to lift or raise up, to raise, erect, elevate II. Neutr., to rise, arise, to get up, stand up
surripio -- to take away secretly; to steal, filch;
surrepo -- to creep under, to creep, steal along, creep softly on, steal upon, to come on unawares, insensibly, by degrees
surreptum -- 
__transse__
transsero -- I. To pass or thrust through II. To transfer by grafting, to ingraft
__abso__
absolutorium -- 
absoluo -- to set free, release, discharge:
absorbeo -- to swallow down, devour:
absolesco -- - intr. - Tert. tomber en désuétude.
absono -- - intr. - détonner.
__depro__
depropinquo -- int., approcher
depromo -- to draw out, draw forth, bring out, fetch
depropero -- to hasten, prepare hastily
depropitio -- to propitiate, reconcile
deproelior -- warring violently
__exa__
exacerbeseo -- erbittert - ( aufgebracht - werden
exauctoro -- to discharge from service, release from the military oath
exacisclo -- - tr. - briser avec une hache.
exaestimo -- - tr. - 1 - estimer. - 2 - considérer comme. - 3 - peser, juger, apprécier, croire (qqch). - 4 - intr. : avoir une opinion, penser, juger, croire.
exasciclo -- - tr. - briser avec une hache.
exauspico -- to take an augury from
exacumino -- tr., ôter la pointe de
exacerbo -- to exasperate, irritate, provoke
exacerbesco -- to become exasperated, irritated, angry
exaspero -- to make rough, roughen
exaudio -- to hear clearly, distinguish, discern, hear
exaggero -- to heap, pile, load, fill
exauguro -- to desecrate, make profane
exaestiuo -- int., c. aestivo
exagella -- moyen de vérification, contrôle
exassulo -- tr., détacher les éclats
exagito -- to rouse, keep in motion, disquiet, harass, persecute, disturb, torment, vex
exaceruo -- tr., entasser, amonceler / exacervans, int., s'amoncelant
exacuo -- to make very sharp, to sharpen, make pointed
exaestuo -- to boil up, foam up, ferment
exagoga -- an exportation, export
exalapo -- to box on the ears
exaperio -- to open wide, throw open
exaporior -- to be in utter perplexity
exareno -- ôter le sable de (+ acc).
exacino -- tr., priver de ses grains
exaequo -- to make equal, place on a level, equal
exalto -- to exalt, elevate, raise; to praise; to deepen;
exardeo -- to burn
exardesco -- to blaze out, kindle, take fire
exarmo -- to disarm, deprive of weapons/arms; to weaken, deprive of military strength;
exigo -- to drive out, push forth, thrust out, take out, expel, divorce, turn out of the house, pours into the sea, by the thrust, passed through, To drive away, hiss off, To require, enforce, exact, demand, collect, demand the construction of, further confirmation, To export, To set right, set precisely upright, to require, demand, claim, exact, insist, has cost, to lead, spend, pass, complete, finish, close, after a long life, in old age, at the end of every year, To conduct, superintend, To bring to an end, conclude, finish, complete, To determine, ascertain, find out, discoveries, before he has ascertained, To weigh, try, prove, measure, examine, adjust, estimate, consider, estimate by the standard of, directed, To consider, deliberate on, take counsel upon
exalbesco -- to turn pale
exalbo -- to make white
exapto -- to fit, adjust
exaquesco -- to turn to water
exascio -- - tr. - 1 - dégrossir (avec la hache). - 2 - ébaucher.
exasceo -- - tr. - 1 - dégrossir (avec la hache). - 2 - ébaucher.
exaugeo -- to increase greatly, confirm
exaresco -- to dry up, become dry
exaro -- to plough out, dig up, dig out
exacesco -- to become sour
exacum -- the Gallic name of the herb, centaury
exagium -- a weighing, weight; a balance
__poste__
posteriores -- posterity
posterula -- I. A small back door or gate, a postern II. A back-way, by-way
postella -- a crupper
posteri -- inferior
postero -- to be behind, later, to come after, to be inferior to, to want, to come short of
__praeob__
praeobturo -- vorn verstopfen
__reex__
reexspecto -- tr., attendre de nouveau$
reexinanio -- to empty again, re-empty$
reexpecto -- to expect, await again
__abstra__
abstraho -- to drag away, draw off, pull away, detach:
__benedi__
benedico -- to bless; to praise; to speak well of; to speak kindly of (classically 2 words);
benedictum -- 1 - bĕnĕ dictum : bonne parole, bon propos. 2 - bénédiction.
__codi__
codicillus -- notepad, small log; writing tablets; patent; petition to Emperor; will/codicil;
codicilli -- a writingtablet, note-book, A note, billet, A petition, An imperial rescript, patent, A will, testament
codicarii -- those who sail on such ships, those who brought the corn from Ostia to Rome
codicula -- a little tail
codiculus -- c. codicillus.
__deper__
deperdo -- to lose permanently/utterly (destruction); to be deprived/desperate; to destroy, ruin;
deperco -- - tr. - épargner, ménager.
__dere__
derelinquo -- to forsake wholly, abandon, desert
derigo -- to lay straight, set straight, arrange, lay out, To draw up, form, To direct, send, aim, drive, steer, to aim, direct, discharge, to direct, guide, define, limit, regulate, points the way
deripio -- to tear off, tear away, snatch away, remove violently, pull down
derupio -- to tear off, tear away, snatch away, remove violently; to pull down
derepo -- to crawl down, sneak down
__distra__
distraho -- to pull asunder, tear in pieces, part, divide
disterno -- to spread out, Impers.
__edis__
edisserto -- to set forth in full, explain, relate
edissero -- to set forth in full, relate at length, dwell upon, unfold, explain, tell
edisco -- to learn thoroughly, learn by heart, commit to memory
__exin__
exinanio -- to empty, make empty, desolate$
exinfulo -- mettre à nu.
__expost__
expostulo -- to demand pressingly, insist on
__incom__
incommodum -- inconvenience, trouble, disadvantage, detriment, injury, misfortune, loss
incommodo -- to occasion inconvenience, be inconvenient, trouble, annoy
incomitio -- to insult, reproach in public
incomium -- one of the ingredients of an ointment
__inim__
inimicitia -- enmity, hostility, well known, transient
inimico -- to make hostile, set at variance
inimicor -- avoir de l'inimitié.
inimica -- 
__peramb__
perambulo -- to ramble through, go through, traverse, perambulate
__pertra__
pertracto -- to touch, handle
pertraho -- to draw along, drag, conduct forcibly
__praere__
praeripio -- to snatch away, carry off, To seize prematurely, presume upon.&mdash;To forestall, anticipate, baffle in advance
__protra__
protraho -- to draw forth, drag out, bring forward, produce
__repor__
reporrigo -- to reach forth or hand again
reporto -- to bear back, bring again, carry back
__subtra__
subtraho -- to draw from below, drag out, draw off, carry off, withdraw, take away, remove
__supersed__
supersedeo -- to sit upon; hence, fig., to be superior to, forbear, refrain, desist, leave off, pass, omit
__transa__
transigo -- to drive through, stab through, pierce through, transfix, transpierce, to carry through, bring to an end, finish, settle, complete, conclude, perform, accomplish, despatch, transact, if all is over, to settle, come to a settlement, agree, reach an understanding, cum, to make an end of, put an end to, have done with, to bring to an end, lead, pass, spend
transactum -- 
__abe__
abecedarium -- a, b, c, the alphabet
abecedaria -- elementary instruction
abellina -- aveline, noisette.
abequito -- to ride away (once):
auellana -- aveline, noisette.
abecedaius -- 
aberro -- to wander out of the way, lose the way, go astray:
aberceo -- - tr. - empêcher, tenir éloigné, éloigner.
abigo -- to drive away, drive off, to drive away, carry off, to force a birth, to drive away, repel, expel
abago -- - tr. - 1 - chasser, renvoyer, éloigner. - 2 - pousser devant soi, emmener, détourner, voler. - 3 - expulser, faire disparaître, dissiper.
__abre__
abrenuntio -- to renounce
abrelinquo -- tr., laisser
abremissa -- Eccl. rémission.
abrelego -- - tr. - éloigner, écarter, reléguer.
abripio -- to take forcibly away, snatch away, tear from, force off, stolen, shall be dragged, to run away, to dissipate, squander, will snatch away in a lump, to carry off, remove, detach, made unlike him
__adim__
adimpleo -- to fill up, to fill full$
adimo -- to take away, take from, deprive of, to free men from sorrow, to deprive of civil rights, grant to Caecilius, yet deny to Vergil, rob, will forbid to write verses, to snatch away, carry off, from death, dead
__adper__
adpertineo -- to belong to, appertain to;, ad
__adsub__
adsubrigo -- - tr. - [se] soulever.
__adsu__
adsumentum -- that which is to be sewed upon, a patch
adsudasso -- to fall into a violent sweat, to sweat profusely, assudescit
adsumo -- to take to oneself, receive:
adsulto -- to leap at, attack, assault
adsultus -- an attack, assault, plur.
adsugo -- to suck
adsudasco -- - intr. - se mettre en sueur.
adsudesco -- to begin to sweat
adsudo -- - intr. - entrer en sueur.
adsuo -- to sew on, patch:
adsuesco -- to accustom, habituate:
__anse__
anserculus -- a little goose, a gosling
anserarius -- celui qui soigne les oies, celui qui garde les oies.
ansera -- oie.
__coan__
coangusto -- to limit, restrict
__coem__
coemeterium -- a churchyard, cemetery, burying-ground
coemitto -- tr., envoyer avec
coemo -- to purchase, buy up, forestall
__coim__
coimagino -- - tr. - Hilar. se représenter avec.
coimbibo -- to imbibe along with, at the same time$
__come__
comestura -- action de manger.
comessor -- to hold a festive procession, to revel, make merry;, Absol.
comedo -- to eat up, eat, consume, devour:
comedus -- a glutton, gormandizer
comesor -- to hold a festive procession, to revel, make merry;, Absol.
cometa -- comète.
__conam__
conamentum -- an instrument for uprooting a plant
conamicus -- der Mitfreund
__concom__
concomitor -- to attend, accompany, part., perf., Part. perf., pass.
__decon__
deconcilio -- to deprive of, take away
decondo -- to secrete
decontor -- to hesitate, to be at a loss
__deco__
decortico -- to deprive of the bark: to bark, to peel
decolligo -- tr., dételer
decoloro -- to deprive of its natural color, to discolor, stain, deface, soil
decollo -- to behead, cause to be beheaded; to remove from the neck (according to Nonius); to rob;
decoquo -- to boil away, boil down, diminish by boiling
decoco -- - tr. - 1 - faire cuire, faire bouillir. - 2 - au fig. faire fermenter, mûrir, sécher. - 3 - réduire par la cuisson, faire évaporer. - 4 - au fig. réduire, affaiblir, diminuer, ruiner. - 5 - intr. - manger son bien, se ruiner, faire banqueroute. - 6 - décroître, se perdre, être ruiné. - 7 - couver, machiner.
decocta -- water boiled down, a cold drink
decoctum -- -I. no. -II. a medicinal drink, potion
decoro -- to adorn, embellish, grace, beautify, decorate, arrayed in spoils, surrounds, to decorate, distinguish, honor
decorio -- to deprive of the skin, outer covering; to skin, to peel
decorum -- seemliness, propriety
decolo -- to come to naught, to fail
__depost__
depostulo -- to demand, require earnestly
__dese__
deseruio -- to serve zealously, be devoted, be subject, be of service
deseco -- to cut off, cut away
desero -- to undo or sever (one's connection with another); to leave, forsake, abandon, desert, give up;
desertum -- desert places, deserts, wastes.
deserta -- the abandoned wife
desecro -- - tr. - consacrer, dédier.
deserpo -- to creep down
desideo -- to sit long, sit idle, remain inactive
desenesco -- to diminish by age, to die away
__desu__
desultura -- a leaping, jumping down
desuspicio -- tr., regarder de dessous
desumo -- to take, choose, select
desilio -- to leap down, dismount, to dismount, jump overboard, dismounted, to leap headlong, venture heedlessly
desulto -- to leap down
desuadeo -- - tr. - Aug. Gloss. dissuader; déconseiller.
desugo -- to suck from, to suck in
desulco -- to furrow through, to plough up
desudasco -- to sweat away; to perspire freely/greatly;
desudesco -- int.  suinter [en parl. des murs]
desudo -- to sweat, make great exertion
desuesco -- to forget/unlearn; to become/be unaccustomed to; to disaccustom; to lay aside custom/habit;
__diob__
diobolaria -- the title of a comedy
__dire__
directarius -- one who, secretly enters a house in order to steal, a sneak-thief, burglar
directorium -- C. Th. itinéraire tracé.
directura -- a making straight, even, a levelling
dirimo -- to take apart, part, separate, divide, cut off, whom the torrid zone parts, to stand between, to break off, interrupt, disturb, put off, delay, to end, To separate, dissolve, break off, To interrupt, disturb, break up, To destroy, frustrate, bring to naught
dirigo -- to distribute, scatter, To lay out, arrange in lines, the rows of houses
directum -- a straight line
diripio -- to tear asunder, tear in pieces, To lay waste, ravage, spoil, plunder, pillage, seized and divided, strip, steal, To tear away, snatch away
__exam__
examarico -- to imbitter exceedingly
examplexor -- to clasp, embrace
examurco -- to cleanse from dregs., to deprive of moisture, to dry
examino -- to weigh, to weigh, ponder, consider, examine, try, test
examina -- c. examen,
examo -- cesser d'aimer
__exco__
excortico -- - tr. - écorcer.
excogito -- to think out, contrive, devise, invent
excoquo -- to boil out, melt out, dry up.
excordo -- - tr. - ôter la raison (à qqn, aliquem).
excolo -- to cultivate, improve, ennoble, refine, perfect
excorio -- to strip of its skin, covering, to skin, strip
__exe__
exedriola -- petite chambre.
exebenus -- a precious stone of a shining white
exerugo -- int., jaillir
exerceo -- to drive, keep busy, keep at work, oversee, work, agitate, keep agoing, employ in labor, to engage busily, occupy, employ, exercise, train, discipline, in whose honor, of exercising ourselves, To practise, follow, exercise, employ oneself about, make use of, ply, mock fights, To follow up, follow out, prosecute, carry into effect, practise, administer, solemnize, To disturb, disquiet, vex, plague
exero -- to stretch forth; to thrust out (of land); to put out (plant); to lay bare, uncover (body);
exedra -- a hall furnished with seats, parlor
exedrium -- a sittingroom, parlor
exerro -- to wander away
exedo -- to eat up, consume, devour
exedum -- a plant otherwise unknown
exigo -- to drive out, push forth, thrust out, take out, expel, divorce, turn out of the house, pours into the sea, by the thrust, passed through, To drive away, hiss off, To require, enforce, exact, demand, collect, demand the construction of, further confirmation, To export, To set right, set precisely upright, to require, demand, claim, exact, insist, has cost, to lead, spend, pass, complete, finish, close, after a long life, in old age, at the end of every year, To conduct, superintend, To bring to an end, conclude, finish, complete, To determine, ascertain, find out, discoveries, before he has ascertained, To weigh, try, prove, measure, examine, adjust, estimate, consider, estimate by the standard of, directed, To consider, deliberate on, take counsel upon
__exem__
exemplare -- arch. pour exemplar)
exemplares -- copies
exemplarium -- A copy
exemplum -- a sample, specimen, representatives of the race, An imitation, image, portrait, draught, transcript, copy, A pattern, model, original, example, precedent, incident, case, a draft, room to show themselves, as an example, by becoming a precedent, by that instance, served as a lesson, for example's sake, A warning example, warning, lesson, penalty, to serve as a warning, A way, manner, kind, nature, after the manner of, A tenor, purport, contents, as follows
exemplo -- to adduce as an example
eximo -- to take out, take away, remove, To free, release, deliver, let you off, to take away, remove, banish, To except, make an exception of, To free, release, deliver, exempt, to consume, waste, lose
__exob__
exobsecro -- to entreat earnestly
__impost__
impostura -- deceit, imposture
__inam__
inamarico -- to imbitter
inamaresco -- to become bitter
__introre__
introrepo -- to creep in
__obre__
obrendarium -- caveau mortuaire
obrelinquo -- dabei zurücklassen
obretio -- to eatch in a net, to entangle
obrepo -- to creep up, approach stealthily, steal upon, come suddenly upon, surprise
obrepto -- to steal on unawares, to come on imperceptibly
__oen__
oenophorium -- a wine-basket
oenophorum -- a wine-holder, wine-basket of unknown shape
oenophorus -- a wine-holder, wine-basket of unknown shape; Oenophorus, f. : the wine-carrier, a female statue of Praxiteles
oenothera -- v. onoth-.
oenotropae -- celles qui changent l'eau en vin
oenanthium -- an ointment made from the grape of the wild vine
oenogarum -- winesauce
oenopolium -- a wine-shop, vintry
oenoferus -- 
oenelaeum -- vin mêlé avec de l'huile
__perdi__
perdiuido -- - tr. - partager.
perdico -- to say out, to finish saying
perdo -- to make away with, destroy, ruin, squander, dissipate, throw away, waste, lose
__pere__
perequito -- to ride through, ride hither and thither, ride about; to drive about
perefflo -- to breathe out entirely, breathe away$
pereffluo -- to flow through., to forget$
perelixo -- to boil thoroughly
pereuacuo -- to empty quite
pererro -- to wander through, roam over
perago -- to thrust through, pierce through, transfix
peredo -- to give forth
__perim__
perimpleo -- - tr. - remplir entièrement.$
perimo -- to take away entirely, annihilate, extinguish, destroy, cut off, hinder, prevent, disappeared, destroyed, To kill, slay
__perin__
perindigeo -- to need very much, to be in great need
perinundo -- to overflow, inundate completely$
perinungo -- to anoint all over$
__perpre__
perpressa -- f, a plant, called also
perprimo -- to press hard, press perpetually, lie upon
__praee__
praeeligo -- to choose rather, to prefer;, object-clause
__praepor__
praeporto -- to bear before
__praepur__
praepurgo -- to purge, cleanse beforehand
__praesur__
praesurgo -- to rise beforehand
__prodo__
prodormio -- to sleep before
prodoceo -- to teach openly, proclaim
__proe__
proegmena -- preferable things (in the Stoic philosophy)
proelior -- to join battle, engage in battle, fight, contended
proelium -- a battle, combat
proelio -- c. proelior.
proebia -- amulettes.
__prosed__
prosedamum -- [mot sarmate], pigritia equorum in coitu
proseda -- a common prostitute
prosedeo -- - intr. - se tenir exposé au public.
__prosub__
prosubigo -- to dig up, cast up
__rea__
reaccendo -- to kindle anew
reagnosco -- to recall to mind$
reagito -- - tr. - Not.-Tir. agiter de nouveau.
rearmo -- - tr. - armer de nouveau.
reaudio -- - tr. - Gloss. entendre un son répercuté.
reago -- tr., pousser de nouveau [fig.]
reatus -- the condition of an accused person, a state of impeachment
__redad__
redadopto -- to adopt anew, to readopt
__redamb__
redambulo -- to come back, return
__redam__
redamptruo -- - intr. - sauter ou danser après qqn, répéter les danses (des Saliens).
redamtruo -- to dance opposite
redamno -- tr., condamner [ce qu'on a jugé] ; se déjuger
redamo -- to return love for love
__retra__
retrado -- to deliver up again, restore
retracto -- to handle again, take in hand again, undertake anew, touches anew the unheeled sores, to consider, examine again, review, revise, the negotiation is renewed, To withdraw, draw back, refuse, decline, be reluctant, have no reason for revoking
retraho -- to draw back, withdraw, call back
__retroa__
retroago -- to drive back, to turn back
__sedim__
sedimentum -- a settling, sinking down, subsidence
__sube__
suberigo -- to raise up$
subeligo -- to choose further
suberro -- to wander about under
subigo -- to drive up, bring up, drive up stream, To turn up from beneath, break up, dig up, plough, cultivate, work, knead, rub down, sharpen, whet, tame, break, easy to be tamed, to put down, overcome, conquer, subjugate, subject, subdue, reduce, To bring, incite, impel, force, compel, constrain, reduce, to cultivate, train, discipline
subedo -- to eat away below, wear away
suberies -- c. suber.
__subex__
subexcuso -- to excuse in part
subexhibeo -- to exhibit under$
__subsu__
subsutura -- the hem
subsulto -- to spring up, to leap, jump, hop
subsummo -- to sum up, to multiply
subsudo -- int., transpirer un peu
__superan__
superantia -- excess, predominance
__supersu__
supersumo -- - tr. - Pl.-Val. prendre en outre.
__suprased__
suprasedeo -- daraufsitzen
__trana__
tranauigo -- - tr. - traverser en bateau.
tranato -- to swim across, pass beyond
__transco__
transcolo -- tr., passer à travers un tamis
__transdi__
transdo -- to give up, hand over, deliver, transmit, surrender, consign
__transen__
transenna -- a netting, lattice-work
__transe__
transero -- I. To pass or thrust through II. To transfer by grafting, to ingraft
transigo -- to drive through, stab through, pierce through, transfix, transpierce, to carry through, bring to an end, finish, settle, complete, conclude, perform, accomplish, despatch, transact, if all is over, to settle, come to a settlement, agree, reach an understanding, cum, to make an end of, put an end to, have done with, to bring to an end, lead, pass, spend
__ade__
adelphides -- die Schwestern - Art Datteln
adequito -- to ride to, gallop to, ride up:
adesurio -- to be very hungry
adipiscor -- to come up with, arrive at, reach, overtake, to attain, get, obtain, acquire, reach, they should take public office, P. pass.
aderro -- to wander to., dat.
adesco -- to feed, fatten
adigo -- to drive, urge, bring by force, take, compelled to come before an arbiter, to ram in, to drive home, plunge, thrust, reach its mark, inflicted, to drive, urge, force, compel, bring, pressed, brought into the form of a ship, to put on oath, bind by oath, cause to take an oath, swear, takes the oath under compulsion
adedo -- to eat away, gnaw at, consume:
__coad__
co/ad/im/pleo -- compléter$
coadiicio -- tr., ajouter avec$
coadolesco -- - intr. - croître avec.
coaduno -- to unite, add, join together, to collect into one
coadiuuo -- tr., assister
coadulesco -- to grow up along with
coaddo -- to add with, add also
coadsum -- int., être présent avec$
__exan__
exancillor -- ganz sklavisch dienen
exanclo -- to exhaust, suffer through, endure
exanimo -- to put out of breath, tire fatigue, weaken, exhaust, To breathe forth, To deprive of life, kill, wear out, to deprive of self-possession, terrify, agitate, stun, wear out, dishearten, out of his wits
exanima -- half dead with fear, terrified, dismayed
exantlo -- pi얰⌋es耀(
__malesu__
malesuadium -- übler Rat, Verführung
__perpur__
perpurigo -- to cleanse, purge thoroughly, to make quite clean.
perpurgo -- to cleanse thoroughly, purge
__rese__
resectorium -- die Nagelschere
resemino -- to sow again, produce again, reproduce
resequor -- to follow, answer, reply
reseco -- to cut loose, cut off
resideo -- to sit back, remain sitting, remain behind, be left, stay, remain, rest, linger, tarry, abide, reside, resting, to remain behind, remain, be left, stay
resido -- to sit down, settle
resecro -- To pray, beseech again, to implore repeatedly
reserpo -- int., ramper vers
reseruo -- to keep back, save up, reserve
resero -- to unlock, unclose, open
__resu__
resuscipio -- tr., reprendre [fig.]
resumo -- to take up again, take back, resume
resupino -- to bend back, turn back, throws down, prostrate, to break down
resulto -- to spring back, rebound, To reverberate, resound, re-echo, ring
resilio -- to leap back, spring back
resulco -- to furrow, plough again, to scratch open
resudo -- to sweat, exude (of the ground)
resuo -- - tr. - 1 - recoudre. - 2 - découdre.
__suben__
subenarro -- to relate
__dein__
deintegro -- to impair, destroy
__detra__
detraho -- to draw off, take down, pull down, take away, remove, withdraw, drag, bring
detrecto -- to decline, refuse, reject, shirk
__dissu__
dissuadeo -- to advise against, dissuade, oppose by argument, resist, object
dissilio -- to leap asunder, fly apart, burst, break up, split, to be broken, be dissolved
dissulto -- to leap apart, fly in pieces, burst asunder
dissuauior -- to kiss ardently
dissulco -- - tr. - séparer par un sillon, fendre.
dissuo -- to unstitich, to rip open;, to, open, to dissolve by degrees
dissupo -- R
dissuesco -- to disuse, to become disused, unaccustomed to
__eman__
emancipo -- to put out of the paternal authority, declare free, emancipate
emancupo -- to put out of the hand, power of, to declare free and independent, to emancipate
emanco -- to maim
emaneo -- To stay without, remain beyond
emano -- to flow out; to arise, emanate from, become known;
__emen__
ementior -- to speak falsely, lie, feign, fabricate, falsify, pretend
emendo -- to free from faults, correct, improve, amend, To correct, revise, To atone for, compensate for
ementum -- Isid. idée, pensée.
eminiscor -- to devise, contrive
emetior -- to measure out; to pass through
__exinter__
exintero -- to disembowel, draw
__expre__
exprimo -- to press out, force out, squeeze forth, had carried up, protruding, To form by pressure, form, model, portray, exhibit, to wring out, extort, wrest, elicit, constrained.&mdash;To imitate, copy, represent, portray, describe, express, may resemble, To render, translate, To pronounce, articulate
__interim__
interimo -- to take from the midst, take away, do away with, abolish, To destroy, slay, kill, To distress intolerably, afflict
__obamb__
obambulo -- to walk before, go around
__obe__
obequito -- to ride towards, ride up to
obeliscus -- an obelisk
obedio -- - intr. avec dat. et tr. - 1 - écouter, prêter l’oreille à. - 2 - être soumis, être docile, obéir.
oberro -- to wander among, ramble about
obedo -- to eat, eat away, devour
obeso -- to fatten
obelo -- - tr. - Isid. marquer d'un obèle.
obelus -- a critical mark, an obelisk
__obo__
oboedio -- to give ear, hearken, listen, To obey, yield obedience, be subject, serve, impers.
oborior -- to arise, appear, spring up
oboleo -- to smell of
obolus -- a small Greek coin, a sixth of a drachma (about three cents, or three halfpence)
__perre__
pergo -- to go on, proceed, press on, hasten, continue, go forward, march, make haste, marched, prosecute your enterprise, speak out, go on to speak, to march on
perrepo -- to crawl over
perrepto -- to creep over, crawl through
__perem__
perimo -- to take away entirely, annihilate, extinguish, destroy, cut off, hinder, prevent, disappeared, destroyed, To kill, slay
peremne -- the auspices taken by magistrates on crossing a river or a spring
peremnia -- auspices pris avant la traversée d'un fleuve.
__persu__
persuadeo -- to convince, persuade
persulto -- to leap about, prance, range through, scour
persulco -- to furrow through, to plough up.
__praesed__
praesideo -- to guard, watch, protect, defend, To preside over, manage, superintend, direct, command
__prore__
prorepo -- to creep forth, crawl out
proripio -- to drag forth, i. e. spring forth
proreta -- the lookout man at the prow, the under-pilot
__subi__
subigito -- to dishonor, lie with
__porre__
porrigo -- to stretch out, spread out, put forth, reach out, extend, by raising hands, extends, lengthen, To lay at length, stretch out, To hold forth, reach out, extend, offer, present, hand, present his head to the marriage halter, manūs, to reach after, strive for, seek to obtain, se, to extend, reach, grow, To prolong, extend
porricio -- to lay before, offer in sacrifice, between slaughter and offering, at the very last moment
porrectum -- 
__adpre__
adprimo -- to press on/to; to clench (the teeth);
adprecor -- to pray to, worship
__adtra__
adtraho -- to attract, draw/drag together/in/before/along; to inhale; to gather saliva; to bend (bow);
__compor__
comporto -- to bring in, carry together, collect, accumulate, gather:
__impre__
imprimo -- to press upon, press against, raised herself, To stamp, imprint, impress, mark, plant, drawn.&mdash;To engrave, stamp, mark, sealed, takes impressions, embossed scene of crime, to impress, engrave, stamp, mark, To stamp, mark
impresso -- - tr. - imprimer fort.
imprecor -- to call down upon, imprecate
__abamb__
abambulo -- - intr. - s'éloigner, se retirer.
__abi__
abigeatus -- cattlestealing
__acon__
acontizo -- to shoot a dart;, to spout, gush forth
aconitum -- a poisonous plant, wolf's-bane, aconite, O., V.&mdash;Poet., poison:
__adamb__
adambulo -- to walk about, at, near a thing, dat.
__adde__
addecimo -- to take by the tenth part, to tithe
addenseo -- to crowd together:
addenso -- eagerly:
__adob__
adobruo -- to cover up with earth, to bury
__adre__
adremigo -- to row to, toward
adrepo -- to creep to, steal up:
adripio -- to snatch, catch hurriedly, grasp, seize, To seize, lay hold of, has buttonholed, arrested for, To take, appropriate, seize, embrace, usurp, make haste to, seize, to me, To seize upon, learn, To ridicule, attack, satirize
adrigo -- to set up, raise, erect, to rouse, encourage, animate, excite, prick up, attentive
__ambad__
ambadedo -- to eat, gnaw around, to eat up entirely
__ambe__
ambecisus -- a cutting around, a rounding off
ambegna -- victime [brebis] ayant deux agneaux
ambedo -- to eat around, waste, consume
__amse__
amsegetes -- propriétaires d'un champ qui borde le chemin.
__anad__
anadesmus -- bande, attache, lien.
__anco__
ancorale -- an anchor-cable
ancora -- an anchor:
__ane__
anellarius -- fabricant d'anneaux.
anellus -- a little ring
anesco -- - intr. - Plaut. devenir vieille, être vieille.
anethum -- dill, anise:
anethus -- c. anethum.
anesum -- anis.
anetum -- aneth (plante aromatique).
__ano__
anorectus -- Pelag. sans appétit.
anomalia -- irregularity, anomaly
__apro__
aprocopes -- qui ne progressent pas, inertes.
apronia -- the plant usually called
__ase__
asellulus -- doub. dim., a small, young ass
asella -- a small she-ass
asellus -- a little ass, ass's colt
asena -- comme arena
__coamb__
coambulo -- to go with
__compur__
compurgo -- to purify completely
__coob__
coobaudio -- - tr. - comprendre en même temps.
__deo__
deoperio -- to uncover, disclose
deoppilo -- - tr. - Gloss. épiler.
deonero -- to unload, disburden
deopto -- choose, select;
deocco -- to harrow in
deorno -- - tr. - Gloss. déparer.
__desub__
desubulo -- to bore in deeply
__diam__
diametrum -- the wantage, loss
__didi__
didintrio -- se dit du cri de la belette
dido -- to give out, spread abroad, disseminate, distribute, scatter (poet.)
__dio__
diogmitae -- a sort of lightarmed frontier troops kept for the pursuit of robbers
dioptra -- an optical instrument
diodela -- plante inconnue
diota -- a twohandled vessel, wine-jar,
__ema__
emargino -- to deprive of its edge
emasculo -- to castrate, emasculate
emacero -- tr., amaigrir
emaculo -- to clear from spots, to purify
ematuresco -- to ripen, to grow mild, be mitigated
ematuro -- to ripen completely, to bring to maturity
emacresco -- to grow lean, to become emaciated
emarcesco -- to wither away, to dwindle away, disappear
emarcus -- a kind of vine, producing a wine of middling quality
emacesco -- to become emaciated
emacio -- to waste away, make lean, emaciate
__emin__
eminiscor -- to devise, contrive
emineo -- to stand out, project, reach upward, to be prominent, stand out, be conspicuous, is distinctly heard, To distinguish oneself, be eminent
emina -- a measure, the half of a, measure
eminor -- Plaut. menacer.
__exab__
exabundo -- to abound exceedingly
__examb__
exambio -- - intr. - 1 - aller çà et là. - 2 - aller à la ronde (pour solliciter), briguer, solliciter.
exambulo -- - intr. - sortir en promenade.
__exen__
exentero -- to disembowel, draw
exenia -- cadeaux.
__exi__
exigentia -- exigence.
exignesco -- to become ignited, turn to fire
__impur__
impuritia -- uncleanness, vileness, impurity
impuro -- tr., rendre impur
__inamb__
inambulo -- to walk up and down, pace to and fro, Impers.
__inem__
inemorior -- to die upon
__insub__
insubulo -- tr., enrouler sur l'ensouple
__insuper__
insupero -- to pass over, surpass;, to conquer
__interan__
interaneum -- intestin
interanea -- intestins
__obsu__
obsufflo -- to blow against, at
obsuo -- to sew on
__oper__
operculo -- to furnish, cover with a lid, to cover
operaria -- a work-woman
operula -- a little trouble, slight service
__pero__
peroriga -- per ou prae, auriga), intendant d'un haras [ou] palefrenier
peroleo -- to emit a penetrating odor
perorno -- to adorn constantly
perodi -- to hate greatly, to detest
perolesco -- to grow up
__proam__
proamita -- f, a great-grandfather's sister
__proda__
prodigo -- to squander, waste
__proem__
proemineo -- to project
__propur__
propurgo -- to cleanse beforehand
__prosu__
prosuppo -- étendre en ligne droite.
prosumia -- a small kind of vessel for reconnoitring, a spy - boat
prosupo -- étendre en ligne droite.
__read__
readopto -- - tr. - adopter de nouveau.
__redan__
redandruo -- - intr. - sauter ou danser après qqn, répéter les danses (des Saliens).
redanimo -- to quicken again, restore to life, reanimate
__redo__
redoperio -- to wrap up, cover again
redopto -- to wish for again
redordior -- to take apart, unweave, unravel
redormio -- to sleep again
redorno -- to adorn again, to readorn
redoleo -- vto emit scent, diffuse odor, smell of, be redolent of
redono -- to give back, restore, return
__rein__
reinuito -- to invite again, in return
reincipio -- tr., recommencer
__retroe__
retroago -- to drive back, to turn back
__sede__
sedecula -- a little seat, low stool
__subad__
subadiuua -- an assistant
subaduno -- to unite
__subim__
subimpleo -- to fill up$
__trase__
trasenna -- a noose, springe, net.
__abspor__
absporto -- - tr. - 1 - emporter, transporter [d'un endroit à un autre]. 2 - emmener [par bateau].
__adex__
adexpeto -- 
__dian__
dianitrum -- remède fait avec du nitre
__dispor__
disporto -- tr., colporter
__perpor__
perporto -- to carry, transport
__prosur__
prosurgo -- to rise up
__reamb__
reambulo -- v. redambulo
__suad__
suadella -- Exhortation, suasion, persuasion, Plur.
suadela -- the goddess of Persuasion
suadeo -- to advise, recommend, exhort, urge, persuade, to be persuaded, to urge, induce, impel, to recommend, advocate, promote, support
__absen__
absentia -- absence; absence form Rome/duty; non-appearance in court; lack;
absentium -- c. absinthium.
absento -- Act., to cause, to be absent, to send away
absentio -- int., être absent
__adem__
adimo -- to take away, take from, deprive of, to free men from sorrow, to deprive of civil rights, grant to Caecilius, yet deny to Vergil, rob, will forbid to write verses, to snatch away, carry off, from death, dead
__como__
comoedia -- a comedy:
comotria -- v. commotria.
__cone__
conecto -- to bind together, connect, entwine, join, unite, link, to connect, to involve in, to connect, join, compose, to conclude, infer, every identical proposition
__consed__
consido -- to sit down, take seats, be seated, settle
consedeo -- - intr. - 1 - être assis avec. - 2 - être assis ensemble.
consedo -- to still, allay, quiet
__dedi__
dedignor -- to reject as unworthy, disdain, scorn, refuse
dedigno -- Drac. c. dedignor.
dedo -- to give away, give up, surrender, deliver, consign, yield, abandon, render
__depor__
deporto -- to carry down, carry off, take away
__dissed__
dissideo -- to sit apart, be remote, to be at variance, disagree, differ, is distracted, to be unlike, be dissimilar, differ, disagree, sits awry
dissido -- - intr. - Sil. camper séparément.
__eme__
emereo -- to obtain by service, earn, merit, deserve
emereor -- achever le service militaire
emeritum -- pension de retraite [pour les soldats]
emetica -- an incitement to vomit, an emetic
emergo -- to bring forth, bring to light, raise up
emercor -- to buy up, bribe
emeto -- to mow away, mow down
emetior -- to measure out; to pass through
emedium -- Isid. char, chariot.
__persed__
persedeo -- to remain sitting, sit continuously
persideo -- trict
persido -- to sink down, penetrate
__reddi__
reddo -- I. To give back, return, restore
redditus -- c. reditus.
__tradi__
trado -- to give up, hand over, deliver, transmit, surrender, consign, drive, To deliver, commit, intrust, confide, To surrender treacherously, betray, to give up, surrender, hand over, deliver, intrust, reflex., to give oneself up, yield, surrender, devote oneself, To make over, transmit, leave, bequeath, it is said that from this arose the custom, To hand down, transmit, pass on, relate, narrate, recount, such is the tradition, to deliver, propose, propound, teach
__esur__
esurio -- to desire to eat, suffer hunger, be hungry, hunger
esuries -- hunger
__susur__
susurrus -- a humming, murmuring, muttering, whispering, Whispers
susurrium -- Hier. médisance.
susurro -- to hum, buzz, murmur, mutter, whisper
__adpro__
adprono -- to lean forwards;
__impor__
importo -- to bring in, introduce, bring from abroad, import
imporco -- to put into furrows;
__abam__
abamita -- sister of an abavus, or great - great - grandfather
__adam__
adamita -- Isid. grand-tante (au quatrième degré).
adamplio -- to widen, to enlarge, to increase, augeamus
adamo -- to fall in love with, conceive desire for, desire eagerly:
adama -- Hier. la race d'Adam, le genre humain.
__amba__
ambactus -- a vassal, dependant
ambages -- a going around, roundabout way, digression, circumlocution, evasion, without circumlocution, A riddle, enigma, dark saying, a dumb show, an enigmatical symbol of
ambaxium -- tas, monceau
__anan__
anancaeum -- a large drinking-cup, which must be drained on a wager, a brimmer, bowl
__depur__
depurgo -- to clean out, cleanse
__disdi__
disdo -- to give out, spread abroad, disseminate, distribute
__ede__
edecimo -- to pick out, select
edecumo -- to pick out, select
edento -- to render toothless, knock out the teeth
edera -- see hedera
__ena__
enauigo -- to sail away
enarro -- to explain fully, recount, describe, interpret
enascor -- to grow up, grow out, sprout, spring up, arise
enargia -- a vivid description
__enco__
encolpiae -- winds that arise in a bay
__epor__
eporediae -- bons cavaliers [mot gaulois]
__ere__
eremigo -- to row, sail through, over, to navigate
eremita -- an eremite, hermit
eremizo -- faire le vide
erigo -- to raise up, lift, set up, erect, elevate, lead up, build, stop, to rise, rising, springs up, tells of their transformation, to arouse, excite, stir, instigate, animate, To raise up, cheer, encourage, we take courage
eripio -- to tear out, snatch away, wrest, pluck, tear, take away, To rescue, deliver, free, reflex., to break away, rescue oneself, escape, to take away, snatch away, take violently, remove, deprive, free, caught up eagerly, was lost, flee, the power of speech, I shall scarcely destroy your desire
erepo -- to crawl over, make a way out of
erepto -- tr., fréq. de erepo, gravir péniblement (une pente)
__expur__
expurgo -- to purge, cleanse, purify
__obi__
obigito -- to disturb
obilla -- Apic. petite jarre.
__obsur__
obsurdesco -- to become deaf
__obtra__
obtraho -- to draw, turn towards
__peran__
peranno -- to live through a year
__repur__
repurgium -- a cleansing again, a cleaning out
repurgo -- to clean anew, cleanse off, clear again
__seco__
secordia -- dulness of mind
__subsed__
subsido -- to sit down, crouch down, squat, settle down, sink down
__surdi__
surditia -- deafness
__cose__
cosentio -- 
__pore__
poricio -- to lay before, to offer sacrifice to the gods, between the slaying and the offering of the victim, at the last moment, at the eleventh hour
__procom__
procomium -- toupet [de cheval]
__ream__
reamplio -- tr., augmenter [fig.], relever
__supre__
suprema -- Varr. Plin. le coucher du soleil, la tombée de la nuit (dernière division légale du jour).
supremum -- the last moment, end
__abdi__
abdo -- to put away, remove, set aside, to go away, betake oneself, to depart, to hide, conceal, put out of sight, keep secret, up to the barb, to cover with, let him rest, buried
abditum -- hidden places, abstruse matters
__cona__
conatus -- an attempt, effort, undertaking, enterprise, endeavor, Effort, exertion, struggle, endeavor, A beginning, undertaking, an impulse, inclination, tendency
conata -- an undertaking, attempt, venture, hazard, plan
conatum -- effort, entreprise.
__conex__
conecto -- to bind together, connect, entwine, join, unite, link, to connect, to involve in, to connect, join, compose, to conclude, infer, every identical proposition
conexum -- a necessary consequence, inevitable inference
__coper__
cooperio -- to cover, cover over, overwhelm, bury, P. pass., buried, involved, covered
__desed__
desido -- to sink, settle down, fall
desideo -- to sit long, sit idle, remain inactive
__emi__
emigro -- to move, depart, emigrate
__ene__
eneco -- to kill off, exhaust, wear out, destroy, torment, plague
enecto -- tr., délier
energia -- energy, efficiency
enecium -- meurtre
eneruo -- to enervate, weaken, make effeminate, deprive of vigor
__insed__
insideo -- to sit upon, settle on, to take place, settle, be fixed, adhere, To take possession of, occupy, inhabit
insido -- to sit in, settle on
__obdi__
obdo -- to put against, shut, close, fasten
__obsed__
obsideo -- to sit, stay, remain, abide, To beset, haunt, frequent, to hem in, beset, besiege, invest, blockade, hampered in every way, Supin. acc., choked, To occupy, fill, possess, is filled, surrounded, take up, besieged, To watch closely, look out for
obsido -- to beset, invest, besiege, blockade
__rede__
redigo -- to drive back, force back, lead back, bring back, to bring back, force back, recall, coerced, To get together, call in, collect, raise, receive, take up, paid into the public treasury, to reduce, bring down, diminish, To bring down, bring, reduce, force, compel, subdue, bring down, reduce to a province, reduce to poverty, render empty and useless, had made it certain, two acc., to make, render, cause to be
__resed__
resideo -- to sit back, remain sitting, remain behind, be left, stay, remain, rest, linger, tarry, abide, reside, resting, to remain behind, remain, be left, stay
reseda -- a plant
resedo -- to assuage, heal, dat.
resido -- to sit down, settle
__sue__
suesco -- to become used, accustom oneself, To accustom, to be wont, be accustomed
suellus -- petit porc
suetum -- a custom, usage
suera -- viande de porc.
__opor__
oporteo -- it is right/proper/necessary; it is becoming; it behooves; ought
__adsed__
adsideo -- to sit by, sit near, attend, is to be classed with, To sit with, To settle, remain, To invest, lay siege to
adsido -- to take a seat, sit down, resume one's seat:
__inre__
inrepo -- to creep in, slip in, be stealthily inserted, steal in
__aman__
amando -- to send away, remove:
amaneo -- - intr. - découcher.
__amen__
amendo -- - tr. - éloigner, reléguer, renvoyer.
__ami__
amigro -- to migrate:
__ani__
anilla -- c. anicula.
__ansu__
ansula -- a little handle, A small ring, hook, A small loop at the edge of sandals for the ties
__apor__
aporria -- écoulement
aporia -- doubt, perplexity, embarrassment
aporior -- to be in uncertainty, to doubt, vacillate
__coi__
coillum -- the inmost part of the house, where the Lares were worshipped
__coma__
comacum -- a kind of cinnamon found in Syria
__cono__
conopeum -- a gauze net, mosquito-curtain, canopy:
__dee__
deerro -- to wander away, go astray, lose the way
__empor__
emporium -- a place of trade, market-town, market, mart
__oe__
oestrus -- a gad-fly, horse-fly, breese
oesypum -- the refuse of wool, wool-washings (a cosmetic)
oetor -- To use, make use of, employ
oetum -- an Egyptian plant, otherwise unknown
__reo__
reorno -- tr., orner de nouveau
__sere__
sereno -- to make clear, clear up, make serene, growing clear
serenum -- temps serein, ciel serein, sérénité.
__sese__
seselium -- c. seseli.
__sui__
suilla -- viande de porc.
__ambo__
ambolo -- 
__encom__
encomium -- praise, eulogy
__suren__
surena -- a kind of fish
__eno__
enodo -- to free from obscurity, explain, elucidate, unfold
enoto -- to mark out, note down
enotesco -- to become known abroad, to become known
__exim__
eximo -- to take out, take away, remove, To free, release, deliver, let you off, to take away, remove, banish, To except, make an exception of, To free, release, deliver, exempt, to consume, waste, lose
__abem__
abemo -- tr., emporter
__aben__
abena -- courroie, lanière, bride, rênes.
__deam__
deamo -- to be in love with
__emad__
emadesco -- int., se mouiller
__esu__
esudo -- 
