Bērōsus	-os
bēryllus	-os
campestris	-ster	-5
capessō	-issō
Caphēreus2	-ēus
chamelaea	-lēa	-4
chīrographum	-grafum	5
circumuertō	-uortō
collīniō	-neō
colostra	-lust-	2
coquibilis	coci-	5
coquīnārius	cocī-	5
coquinātōrium	coci-	5
coquinātōrius	coci-	5
coquitātōrius	coci-	5
corniculum	cornu-
crocodīlus	-illus	-4
crystallum	crus-
Culminius	-eus
Cȳrēnae	Cūr-
dēfaenerō	-fēn-	2	-3
dēfatīgātiō	-fet-	2
dēfatīgō	-fet-	2
Dēidamīa	-ēa
dēliquō	-cō	3
dēsacrō	dēsec-	-2
digitellus	-ill-	-5	-2
dīrectārius	dē-
dīrectim	dē-
disiciō	diss-	3
dissipābilis	dissu-	
dissipātiō	dissu-
dissipātus	dissu-
dissipō	dissu-
documen	doci-
documentum	doci-
dorsuārius	doss-
dorsum	doss-
dorycnion	-ium
duodecimus	-umus
duumuirālicius	duou-	3
duumuirālis	duou-	3
duumuirātus	duou-	3
effingō	ecf-
effrēnātē	ecf-
ēlecebra	exl-	1
elephantus	elef-	5
elleborinē	hell-	3
elleborītēs	hell-	3
elleborōsus	hell-	3
elleborum	hell-	3
ēnumquam	-un-	2	4
ēsitō	ess-	2
Esquiliae	Exq-	3
Esquilīnus	Exq-	3
ēsuriālis	ess-	2
ēsuriens	ess-	2
ēsuriō1	ess-	2
ēsuriō2	ess-	2
etiamnum	-nunc	-3
etiamtum	-tunc	-3
Euēnus	-os
ēuulgō	ēuolg-	
exedra	exh-	2
exedrium	exh-	2
exhālō	exāl-	-1
fāticanus	-cinus
filicōnēs	fel-
fringilla	-uilla
Gallaecia	-cus
gangraena	-rēna	-5
gizeria	gig-
glaucium	-ion
glycymaris	glycom-
grabātulus	-att-	4	-4
grabātus	-att-	4	-2
haliāetos	-us
heleoselīnum	helīo-
Hercēus	-īus
Hermionēus	-aeus	-3
hilarescō	-iscō
hirneacus	erni-	4
Horātius	Or-	3
hōria	-eia	-2
Hypsipylēus	-aeus	-3
illices	inl-
impūnō	inp-
insuptīlis	-iter	-2
intrōuorsus	-uers-	4
Lacētānia	-ānus	-4
Lālētānia	-ānus	-4
Lapithaeus	-ēus
lolleāceus	-ācius
longurius	-orius
manuductor	manū-
Mediolānium	-num	-3
medioximus	-umus
Megalensia	-ēsia	-5
Megalensis	-ēsis	-5
mīliens	-iēs	-4
miserimōnium	-mūnium
Mithridātēs	Mitr-	5
Mostellāria	Must-	
mūculentus	mucc-	3
Myrmēcidēs	Murm-
mystērium	mist-
Nērēis	-ĕis
obiciō	obiic-	-2
obnoxiōsē	-ossē	-3
obstipescō	-stupescō	2
octōgēsimus	-ensimus	5
Odyssēa	-īa
oleāgineus	oliā-
oleārius1	oliā-
Olisīpō	-ippō	-3
pacō1	pag-	-1
Pamphȳlius	-phīl-	3	-3
parsimonium	parc-
Parthīnī	-ēnī
paruulus	-olus
pectinārius	pecten-
pectinātus	pecten-
pecuārius1	pequ-
pecūlātus	peq-
pēierātiuncula	pēii-
pēiūriōsus	pēii-
pēiūrium	pēii-
pēiūrus	pēii-
pentaetēricus	pentahe-	6
percontātiō	-cunct-	3	-4
percontor	-cunctor	3
peruersāriō	-uors-	3
Philētās	-ītās
Philētēus	-līt-	3
Phrixēus	Phryx-
pīleus	-eum
pilleātus	pīle-	5
pilleus	pīle-	5
pōculum	-clum	2
polygona	poli-
postergum	-ga	-3
Postuerta	-uort-	4
praesēpe	-saepe	4
praesēpiō	-saep-	4	-2
praesēpium	-saep-	4	-3
praeuertō	-uortō	4
prōtinus	-tenus	3
Ptolomaeēus	Ptolem-
pūblicitus	pupl-
quadruuium	-uius
Quintilius	-illius	-5
quotiens	-iēs	-4
radiōsus	-ssus	-3
raeda	rēd-	-1
raedārius	rēd-	4
Raetia	Rhaet-	-2
Raeticus	Rhaet-	-4
Raetus	Rhaet-	-2
reciperātiō	recup-
reciperātor	recup-
reciperō	recup-
reuertor	reuor-
sacrificulus	-olus
sandaracinus	sande-
Sārītor	Sarr-	-4
Sassina	Sars-
sāuiolum	suā-
sāuior	suā-
sāuium	suā-
schoeniculus	-olus
scholasticus	scol-	5
Scylacēus	Scyll-	4
sēligō	-egō
sēmirotundus	-rut-	4
senica	-ec-	3
septentriōnālis	-temt-	3
septimātrūs	-ptem-	2
sequella	-ēla	-4
sēricāria	sīr-	
sēricārius	sīr-
seruīliculus	-col-	-5
seruola	-ula
seruolus	-ulus
sēsamum	-on
sescēnārius	sexc-
sescentēsimus	sexc-
sescentī	sexc-
sescuncia	sexc-
sesquialter	sesque-
sesquioctāuus	sesque-
sesquiopus	sesque-
sesquiplicārius	sescup-	7
sesquitertius	sesque-
Sesquiulixēs	Sescul-	-4
sēuir	sexu-	-2
sēuirālis	sexu-	3
Sextiānus	Sest-
Sextius	Sest-
Sibylla	-bul-	2
simila	-ula
simulō	simil-
smaragdinus	zm-
smaragdus	-os
smaris	zm-
smecticus	zm-
smegma	zm-
smīlion	zm-
Sminthēus1	Zm-
Sminthe͡us2	Zm-
Sminthius	Zm-
Smyrna3	Zm-
smyrnaeum	zmu-
Smyrnaeus	Zm-
smȳrus	zm-
sōlistimus	-umus
sorbillō	-ilo	-4
sorticula	-cola
spēlaeum	-lēum	3
spetile	spect-	-3
Stagīrītēs	Stagē-
Stellās	-ātis	-2
stephanēplocos	stephano-
stribilīgō	stribl-	-3
subfusculus	suff-
subpolītor	supp-
subruptīcius	surr-
subuīlicus	-uill-	-4
Subūrānensēs	-ēsēs	-5
suffarcinō	subf-
sufferō	subf-
suffodiō	subf-
suffrāgātiō	subf-
suffrāgium	subf-
suffringō	subf-
suffugiō	subf-
suffūmigō	subf-
suffundō1	subf-
suffūror	subf-
suffūsiō	subf-
suggerō	subg-
suggillō	-ilō	-4
suggrundium	subgr-
sulpurātiō	sulph-	4
sulpurōsus	sulph-	4
Sūnium	-ion
suouetaurīlia	suoui-
supergredior	-grad-	-7
superilligō	-inl-	-6
superillinō	-inl-	-6
suppeditō	subp-
suppetior	subp-
suppetō	subp-
suppīlō1	subp-
suppīlō2	subp-
supplantō	subp-
supplēmentum	subp-
suppleō	subp-
supplicium	subp-
supplicō	subp-
supplicuē	subp-
supplōdō	subp-
supplōsiō	subp-
suppōnō	subp-
supportō	subp-
suppositīcius	subp-
supprimō	subp-
suppūrātus	subp-
Surrentum	Syrr-
suscenseō	succ-
susceptor	succ-
suspiciō1	subsp-	4
Sybaris	Sub-
Sybarītānus	Sub-
sybina	sub-
sȳcomoros	-us
sȳcophanta	sūc-
Syēnītēs	Suēn-
symbolus	sumb-
symmetria	summ-
symmystēs	-ust-	4
synagōga	sin-
syngrapha	-af-	5	-1
Syphax	Syf-	-2
Syriāticus	Sur-
Syriscus	Sur-
Sȳros	-us
Syrus2	Sur-
tabernula	-ola
taminia	-ea
tamnus	tham-	-3
tamquam	tan-
Tarentum2	Ter-
Tarracīna	Terr-
Tarracīnensēs	Terr-
Tēleboae	Tēlo-
terdeciens	-iēs	-4
terebinthinus	-enth-	5
Terpsichorē	-cor-	6	-1
terripauium	-pudium	5
testāceus	-ius
tetrachordos	-cord-	5	-2
tetrastȳlos	-stūl-	6
Thermopylae	-pul-	6
Thrasyllus	-ull-	5
Thūcȳdidēus	-īus
Thybris1	Tyb-	4
Thȳnia	Thū-
thynnus	thun-
Tigellīnus	Tigil-
tōfus	tōph-	3
Trasumennus	-ēnus	-5
tremebundus	tremi-
Triballia	Treb-
tripertītō	tripart-
tripertītus	tripart-
Tubilustrium	Tubul-
tyrannus	tur-
uehiculum	-clum	-5
uerrūcōsus	-ossus	-4
uīcēsimārius	uīcens-	5
uīcēsimus	uīcens-	5
uictima	-tum-	3	-1
uictimārius	-tum-	3
uīneāticus	uīniā-
uiolāceus	-ācius
uirgineus	-ius
ultimus	-umus
ūmor	hūm-	2
ūnanimus	ūnian-	4
undecimānus	-decum-	2
undecimus	-decum-	2
undecumque	-cunque	4
Uenerius	-eus
Uirdomarus	Uirdu-
Uolcānālia	Uulc-
Uolcānālis	Uulc-
Uolcānius	Uulc-
Uolcānus	Uulc-
Uologēsus	-gaes-	4	-2
Uolsiniensis	Uuls-
Uolsiniī	Uuls-
Uoltur1	Uul-
Uolturnus1	Uul-
Uolturnus3	Uul-
zōnarium	sōn-
offerumentum	obf-
