! If line starts with # then word is not a synonym
! If line starts with * then word is a synonym but is spelled highly different
Adōneus1	  m.   = Adōnis.
Areios pagus	  m.   = Areopagus.
Arēos pagos	  m.   = Areopagus; (in quotation) the court of the Areopagus.
Asclēpius	   = Aesculāpius1.
Bactrīnus	     ~a, ~um     adj.   = Bactriānus. camelo ~ae   Apul.     Met.   7.14.
Bactrius	     ~a, ~um     adj.   = Bactriānus.   Ov.     Met.   5.135;   Plin.     Nat.   8.67.
Bēlias	     ~ados     f.   = Bēlis.
bicrotum	     ~ī     neut.   = dicrotum.
Boebēis	     ~idos     f.   = Boebē.
*Boōtēs	     ~ae or ~ī     m.   Forms:   ~i   (dative)   Cic.     N.D.   2.110. The constellation Bootes (= Arctophylax).
Britanicīnius	     ~a, ~um     adj.   = Britanniciānus.
Brittanicīnus	     ~a, ~um     adj.   = Britanniciānus.
callistrūthis	     ~idis     f.   = callistrūthia.
canāle?	     ~is     neut.   = canālis.
canālicula	     ~ae     f.   = canāliculus.
Caphēris	     ~idos     f. adj.   = Caphēreus2.
Capitōlīnum	     ~ī     neut.   = Capitōlium.
Capitōlius	     ~a, ~um     adj.   = Capitōlīnus; (neut. pl. as noun, perhaps) the Capitoline games.
carbasineus	     ~a, ~um     adj.   = carbasinus.   Var.   in   Non.   p.541M.
carbasus2	     ~a, ~um     adj.   = carbaseus.
Carthēius	     ~a, ~um     adj.   = Carthaeus.
Carystius	     ~a, ~um     adj.   = Carystēus.
Casilīnensēs	     ~ium     m. pl.   = Casilīnātes.
Caspiacus	     ~a, ~um     adj.   = Caspius 2b.
Caspiānī	     ~ōrum     m. pl.   = Caspiadae.
Caspias	     ~adis     f. adj.   = Caspius 2.
cassida	     ~ae     f.   = cassis1.
castitūdō	     ~inis     f.   = castitās.
castra2	     ~ae     f.   = castra1.
catascopiscus	     ~ī     m.   apparently = catascopium.   CIL   8.27790.
cauaedium	     neut.   = cauum   aedium  , an inner court in a house.
Caucasius	     ~a, ~um     adj.   = Caucaseus.   portae ~ae  , a pass in the Caucasus.
Centemmanus	     ~a, ~um     adj.   (appell.) = centimanus.
cercius	     ~iī     m.   = circius.
Cestīnus	     ~a, ~um     adj.   = Cestiānus.
cingula	     ~ae     f.   = cingulum (  c  ).
Cinneus	     ~a, ~um     adj.   = Cinnānus.
Cinyrēus	     ~a, ~um     adj.   = Cinyrēius;   ~a germina  , myrrh.
circumforānus	     ~a, ~um     adj.   (dub.) = circumforāneus 2.
circumluuium	     ~iī     neut.   (apparently) = circumluuiō.
Citie͡us	     ~a, ~um     adj.   = Citiensis.
Cīus	     ~a, ~um     adj.   = Cēus.
Clymenēus	     ~a, ~um     adj.   = Clymenēius (in quotation of the daughters of Clymene).
Clymenus2	     ~ī     m.   The name of var. mythological, persons, especially = Pluto.
cnātus	   =   gnatus   (nātus).
cōbiō	   =   gobio   (see gōbius).
cōlēpium	     ~iī     neut.   = cōlȳphium.
Colminiānus	     ~a, ~um     adj.   = Colminius.
comedus	     ~ī     m.   = comedō2.
*Cōrycides	     ~um     f. pl.     ~es nymphae = Coryciae nymphae   (see Cōrycius).
Crustumerīnus	     ~a, ~um     adj.   = Crustumīnus.
Crustumius	     ~a, ~um     adj.   = Crustumīnus b.
cūriātius1	     ~a, ~um     adj.   (inscriptions) = cūriātus.
cȳnon	     ~ī     neut.   = co͡enon.
Cytaeis	     ~idis     f.   = Cytaeīnē.
Cytherēia	     ~ae     f.   = Cytherēa.
Cytherēis	     ~idis (~idos)     f.   = Cytherēa.
Daedalius	     ~a, ~um     adj.   = Daedalēus.
Daulis2	     ~idos     f. adj.   = Daulias.
Dicarchis	     ~idos     f.   = Dicaearchēa.
Dōdonis	     ~idos     f. adj.   = Dōdōnaeus.
duouicēsimus	   = duoetuīcēsimus (according to   Gel.   5.4).
eāpropter	     adv.   = proptereā, on that account.
Eleusīnus	     ~a, ~um     adj.   = Eleusīnius.
Elissaeus	     ~a, ~um     adj.   Of or belonging to Dido; (in quotations, poet. = Carthaginian).
Ēmathis	     ~idis     f. adj.   = Ēmathius.
Ephyrēius	     ~a, ~um     adj.   = Ephyraeus.
Epidauricus	     ~a, ~um     adj.   = Epidaurius.
Ēpīrensis	     ~is, ~e     adj.   = Ēpīrōticus.
Eretricus	     ~a, ~um     adj.   Of or belonging to Eretria; (pi. as noun) = Eretriacī.
Eretriensis	     ~is, ~e     adj.   = Eretricus; (pl. as noun) the citizens of Eretria.
Erycus	     ~ī     m.   = Eryx.
Erymanthis	     ~idos     f. adj.   = Erymanthias.
Esquilius	     ~a, ~um     adj.   = Esquilīnus.
Eubois	     ~idis     f. adj.   = Euboicus.
extempore	   =   ex tempore   (see tempus1).
exuuium	     ~(i)ī     neut.   = exuuiae. ~io plenus ab hoste redis   Prop.   4.10.6.
facul	     adv.   = facile.
faculter	     adv.   = facile.
fallāciēs	     ~ēī     f.   = fallācia.
falsē	     adv.   = falsō1.
farfugium	     ~(i)ī     neut.   = farfarum.
fasēna	   Sabine word = harēna.
Faustiānus	     ~a, ~um     adj.   (of wine) = Faustīniānus.
Ferentānus	     ~a, ~um     adj.   = Ferentīnus b.
Flōrius	     ~a, ~um     adj.   apparently = Flōrālis.
*fore	   =   futurum esse  , used as future infinitive of sum1.
fortassis	     adv.   = fortasse:
frigō3	     ~ere     tr.   (According to   Non.   p.308M = ērigō, to raise; perhaps originally a misreading of   erigo  .)
*galbeolus	     ~ī     m.   (apparently) = Merops1, the bee-eater.
Gallius	     ~a, ~um     adj.   = Gallicus1.
Gangētis	     ~idis     f. adj.   = Gangēticus. domita ‥ ~ide terra   Ov.     Am.   1.2.47.
Garamantis	     ~idis     f. adj.   = Garamanticus. rapta ~ide nympha   Verg.     A.   4.198; ~idas attigit undas   Luc.   9.369; ~ide pinu   Sil.   14.498; gemma ~ide 15.676.
gēsum	     ~ī     neut.   = gaesum.
Gortȳnis	     ~idis or ~idos     f. adj.   = Gortȳniacus.
Haeduī	   = Aeduī.
Hellespontius	     ~a, ~um     adj.   = Hellesponticus; (m. as noun) -an inhabitant of that region.
Hibēriacus	     ~a, ~um     adj.   = Hibēricus.
Hippōnius	     ~a, ~um     adj.   Of Hipponium (= Vibo), a town in the territory of the Bruttii.
Hippotadēs	     ~ae     m.   A descendant of Hippotes, usu. = Aeolus.
Hyantius	     ~a, ~um     adj.   = Hyantēus;   ~ae sorores  , The Muses.
Iānuspater	     m.   = iānus.
Idūmaea	     ~ae     f.   = Idūmē.
Īliēnus	     ~a, ~um     adj.   = Īliensis.
Illyria	     ~ae     f.   = Illyricum.
Illyris2	     ~idis     f.   = Illyricum.
Īnachus2	     ~a, ~um     adj.   = Īnachius.
*insecendus	     ~a, ~um     adj.   word of dub. sense quoted from   Cato   by   Gel.   18.9.2; perhaps gerundive of insecō2 or in-2 +   secendus   (as in insecō2; = unspeakable).
Interamnium	     ~(i)ī     neut.   = Interamna (in Umbria).
interātim	     adv.   = interim.
Īonius	     ~a, ~um     adj.     mare ~um (also neut. as noun)  , the sea to the west of Greece, the Ionian sea; of or proper to the Ionian sea; also apparently = Ĭōnicus.
iouistē	     adv.   perhaps = iustē (cf.   iouestod  , perhaps =   iusto  , in   CIL   1.1).
Īphianassa	     ~ae     f.   = Īphigenīa.
Ismarus2	     ~a, ~um     adj.   = Ismarius.
Isthmicus	     ~a, ~um     adj.   = Isthmiacus.
Isthmius	     ~a, ~um     adj.   = Isthmiacus.
Ithacēsius	     ~a, ~um     adj.   = Ithacensis.
Lacōnia	     ~ae     f.   = Lacōnica.
Lapithēius	     ~a, ~um     adj.   = Lapithaeus.
Lātō	     ~ūs     f.   Leto (= Lātōna).
Lāuīnus	     ~a, ~um     adj.   = Lāuīnius.
Lelegēis	     ~idis     f. adj.   = Lelegēius; (as noun) an old name for Miletus.
Liburnica	     ~ae     f.   = Liburna.
Liburnus1	     ~a, ~um     adj.   Of or belonging to the Liburnians;   nauis ~a  , = Liburna.
liciniō	     ~āre     tr.   (Word of unknown meaning, perhaps f.l. for   linio = lineo  , in presumed sense 'to outline'.).
Ligustīnus	     ~a, ~um     adj.   = Ligusticus; (m. pl. as noun) The Ligurians.
Lilybēius	     ~a, ~um     adj.   = Lilybaeus.
Lingonus	     ~a, ~um     adj.   = Lingonicus; (m. of noun) A member of the Lingones.
Liparitānus	     ~a, ~um     adj.   = Liparensis.
Līternus	     ~a, ~um     adj.   = Līternīnus.
Lūcullēus	     ~a, ~um     adj.   = Lūcullānus.
Lūculliānus	     ~a, ~um     adj.   = Lūcullānus.
Lyncestus	     ~a, ~um     adj.   = Lyncestius.
Lyrcēius	     ~a, ~um     adj.   = Lyrcēus.
Maeōtius	     ~a, ~um     adj.   = Maeōticus.
Magnēsius	     ~a, ~um     adj.   = Magnēs1;   ~um saxum  , The loadstone.
Marōniānus	     ~a, ~um     adj.   = Marōnēus2.
Maurētānus	     ~a, ~um     adj.   = Maurētānicus.
Mēdica2	     ~ae     f.   = Mēdia1.
Megarēa	     ~ōrum     neut. pl.   = Megara1 (or accusative of Megare͡us2 = Μεγαρη̑α).
Mendēsicus	     ~a, ~um     adj.   = Mendēsius.
*merois	     ~idis or ~idos     f.   An unidentifiable Ethiopian plant, = aethiopis.
Mēthymnias	     ~adis     f. adj.   = Mēthymnaeus.
mī1	   =   mihi  , dative of ego.
Minyēis	     ~idis or ~idos     f.   = Minyēias.
Moesiāticus	     ~a, ~um     adj.   = Moesiacus.
Molossicus	     ~a, ~um     adj.   = Molossus1.
Moschus	     ~a, ~um     adj.     montes ~i = mons   Moschicus.
Mūgiōnius	     ~a, ~um     adj.     porta ~a = porta Mugionis   (see Mūgiō2).
Mygdonis	     ~idis or ~idos     f. adj.   = Mygdonius.
Myiōdēs	     m.   = Myiacorēs.
Nemeēius	     ~(i)ī     m.   = Nemeaeus2.
Nephelēias	     ~adis or ~ados     f.   = Nephelēis.
Neptūnuspater	     m.   = Neptūnus pater.
Nērēīnē?	     ~ēs     f.   = Nērīnē.
*Nēritius	     ~a, ~um     adj.   Of or deriving from Neritos in Ithaca (poet. = Ithacan).
Nerōniānus	     ~a, ~um     adj.   = Nerōnēus.
Nīlōtis	     ~idis or ~idos     f. adj.   = Nīlōticus.
Nīsēius	     ~a, ~um     adj.     ~a uirgo   = Nīsēis.
Numidiānus	     ~a, ~um     adj.   = Numidicus; (in quotation, the name of a variety of pear).
Nȳsēius	     ~a, ~um     adj.   = Nȳsaeus 1. iuga ‥ uacant Bromio ~a   Luc.   8.801.
Nȳsias	     ~adis or ~ados     f. adj.   = Nȳsēis. ~adas nymphas   Ov.     Fast.   3.769.
Nȳsius	     ~a, ~um     adj.   = Nȳsaeus 1.   (as a title of Bacchus)   tuas ..  imitatur, ~e, uitis ‥ sentis   Col.   10.248;   (cf.)   Mithridatem ..  Euhium, ~um, Bacchum, Liberum nominabant   Cic.     Flac.   60;    (hedera)   quam quidam ~am, alii Bacchicam uocant   Plin.     Nat.   16.147.
octāuīdūs	     adv.   (apparently) =   octauo (sc. die) Idus  , On the eighth day before the Ides.
Odrysiī	     ~ōrum     m. pl.   = Odrysae.
Oedipodēs	     ~ae     m.   = Oedipūs.
*Oenōtrī	     ~ōrum     m. pl.   A people inhabiting southern Italy in early times; (poet. = the Italians in general).
*Oenōtrius	     ~a, ~um     adj.   Of or belonging to the Oenotri (in quotations, poet. = Italian).
*Oenōtrus	     ~a, ~um     adj.   Of the Oenotri; (also poet. = Italian).
#oetum	     ~ī     neut.   A plant with an edible root, perhaps = Greek οὔιτον or οὔιγγον (  Egyptian arum  , Colocasia antiquorum), but if so, badly described.
Olympium	     ~iī     neut.   = Greek Ὀλa3 μπιον or   Ὀλυμπει̑ον   alleged forms of Ὀλυμπιει̑ον. (See Olympiēum.)
ostraciās	     ~ae     m.   = ostracītis a.
ostrya	     ~ae     f.   = ostrys.
Pagasēius	     ~a, ~um     adj.   = Pagasaeus.
Pallantis	     ~idos     f.   = Pallantias; (in quotations transf.).
pānicium	     ~iī     neut.   = pānicum.
Panopēa	     ~ae     f.   = Panopē1.
Paraetonicus	     ~a, ~um     adj.   = Paraetonius (in quotation, 2a).
Parnēthus?	     ~ī     f.   = Parnēs.
Pataricus	     ~a, ~um     adj.   = Patarēus2.
Patricolēs	     ~is     m.   = Patroclus.
Pēgasēius	     ~a, ~um     adj.   = Pēgaseus.
Pelopēis	     ~idos     f. adj.   = Pelopēias; (as noun) a female descendant of Pelops.
Pelopēus	     ~a, ~um     adj.   = Pelopēius.
Peloponnēsum	     ~ī     neut.   = Peloponnēsus.
Pelōriadēs	     m.   = Pelōrus.
Pēnelopēa	     ~ae     f.   = Pēnelopē.
#Persēius2	     ~a, ~um     adj.   Of or belonging to the hero Perseus; (poet. = Argive, because Perseus was associated with Argos).
Phaeācus	     ~a, ~um     adj.   = Phaeācius.
Pharsālius	     ~a, ~um     adj.   Prosody: 2nd syllable short in   Catul.   64.37. = Pharsālicus.
Philippus2?	     ~a, ~um     adj.   (apparently) = Philippēus.
Pīcentiānus	     ~a, ~um     adj.   = Pīcentīnus b.
pitheus	     m.   = pithiās.
polygona,	     poli-     ~ae     f.   = polygonus.
polygonium	     ~iī     neut.   = polygonus.
porcilia	     ~ae     f.   = porcilla.
Postuorta	   = Postuerta.
Pōtica	     ~ae     f.   = Pōtīna.
Praetūtiānus	     ~a, ~um     adj.   = Praetūtius.
propromptū?	   apparently =   promptu   (promptus2).
#psin	   = Greek ψίν (  Syracusan form of   σ   ϕ   ίν).
#Ptolomēicus	     ~a, ~um     adj.   Of or named after the Ptolemies;   pes ~us  , a measure of length = 1 1/24 of the Roman   pes  ; .
*pus2	     (in a mixed Latin and Oscan inscription, particle introducing wishes, = ut)  .
Pyriphlegethōn	     ~ontis     m.   One of the rivers of the Underworld, = Phlegethōn.
Pȳthagoricus	     ~a, ~um     adj.   = Pȳthagorēus.
Quirītis	     ~is     f.   A cult title of Juno, = Cūrītis.
#quirquir?	   obscure word in augural formula cited in   Var.     L.   7.8, perhaps = 'wherever' (root of quisquis with   -r   suffix as in cūr).
rassus	   =   rasus   (rādō).
Rhamnūsis	     ~idis     f.   =   Rhamnusia uirgo  , Nemesis.
Rhoetion	     ~iī     neut.   = Rhoetēum.
Rōmāniensis	     ~is, ~e     adj.   = Rōmānensis;   sal ~e  , salt from the salt pans near the mouth of the Tiber.
rosmarīnum	     ~ī     neut.   =   ros marinus   (see rōs 3).
#Rūmina2	     ~ae     f. adj.     ficus ~a   (poet.) =   ficus Ruminalis   (see Rūminālis1).
Sābātius	     ~a, ~um     adj.   = Sābātīnus.
sagātus2	     ~a, ~um     adj.   (apparently) =   saginatus   (sagīno).
sam1	   (=   eam  ) see sum2.
sam2	   (=   suam  ) see suus.
Sangarius	     ~(i)ī     m.   A Phrygian river = Sagaris; (as adjective)   puer ~ius  , Attis.
saturēum	     ~ī     neut.   (dub.) apparently= saturēia2.
Scandiae	     ~ārum     f. pl.   A group of islands supposed to lie off the coast of Britain, probably = Scadinauia.
scensa?	     ~ae     f.   (see quotation; probably corrupt for *  scesna = cesna  , old form of cēna).
Scyllēius	     ~a, ~um     adj.   = Scyllaeus 1. Argo saxa pauens postquam ~a (  s.v.l.  ) legit Cyaneosque metus   Eleg. Maec.   107.
Scȳrīnus	     ~a, ~um     adj.   (apparently) = Scȳrius; (in quotation, applied to garments, perhaps denoting a special make).
Scythicus	     ~a, ~um     adj.   Of Scythia or its people, Scythian;   herba ~a   = Scythicē.
Scythissa	     ~ae     f.   = Scythis.
Segetia	     ~ae     f.   = Segesta2.
segnitior	   =   segnior   (segnis).
Seruīliānus	     ~a, ~um     adj.   Named after a Servilius;   lacus ~us   = lacus Seruīlius;   horti ~i  , some pleasure gardens in the south of Rome.
Sīthonis	     ~idis or ~idos     f. adj.   = Sīthonius; (as noun) a Sithonian or Thracian woman.
*Sīthonius	     ~a, ~um     adj.   Of the Sithonii (often, loosely = Thracian).
Sminthius,	     Zm-     ~a, ~um     adj.   = Sminthēus1.
Smyrna2	     ~ae     f.   = Myrrha1.
solinō?	     verb   (see quotation; probably a misunderstanding of   solinunt = solent  ).
solitātim?	     adv.   (in   Fro.     Ver.   2.p.144(127N), in a mutilated passage, apparently either from   solito  ,   solitus  , = customarily, or from sōlitās= solitarily).
*solitaurīlia	     ~ium     neut. pl.   (popular corruption of suouetaurīlia, but first elem. referred by ancient grammarians to   sollus   =   totus  ,   solidus  ).
Sōtadicus,	     ~os     ~a, ~um (~on)     adj.   = Sōtadēus.
spīnea	     ~ae     f.   = spiōnia.
#sterōma	     noun   (apparently) = Greek στρω̑μα, a pavement.
Stymphālicus	     ~a, ~um     adj.     auis ~a = auis   Stymphālis.
Syriāticus,	     Sur-     ~a, ~um     adj.   = Syriacus.
tanne	   =   tamne   (see tam).
Tantalicus	     ~a, ~um     adj.   = Tantaleus.
Tartarinus	     ~a, ~um     adj.   = Tartareus.
Teuthrantēus	     ~a, ~um     adj.   = Teuthrantius (in quotation poet., for Mysian).
Thaumantis	     ~idos     f.   = Thaumantias.
*Therapnaeus	     ~a, ~um     adj.   Of or native to Therapnae; (sometimes loosely = Spartan, Laconian).
Thermōdontius	     ~a, ~um     adj.   = Thermōdontiacus.
Thoantis	     ~idis or ~idos     f.   = Thoantias.
Thrācicus	     ~a, ~um     adj.   = Thrācius.
Thȳnēius	     ~a, ~um     adj.   = Of Thynia (Bithynia).
Thȳnēus	     ~a, ~um     adj.   = Thȳnēius.
Titiēs	     ~ium     m. pl.   =   Titienses   (Titiensis).
Torōnaicus	     ~a, ~um     adj.     mare ~um = sinus   Torōnaeus.
Trāchas	     f.   (apparently) = Tarracīna.
trebla?	     ~ae     f.   (apparently = trībulum, but the word may be a proper name).
tripodō	     ~āre, ~āuī, ~ātum     intr.   = tripudiō.
*tulat	   =   ferat   (subjunctive from root   tel-   as in tollō,   tetuli   or   tuli   (perfect of ferō); cf. Plautine   attigas = attingas  ).
tux pax	     interj.   (perhaps = tuxtax, but according to gloss cited in footnote,   Char.   p.238K, an exclamation of thanks).
Tȳphōn2	     ~ōnis (~ōnos)     m.   = typanum.
uapio	   (word found on   tesserae  , perhaps =   uappa  ).
uespa2	     ~ae     f.   = uispillō.
Uenāfer	     ~fra, ~frum     adj.   = Venāfrānus.
Uesēuus	     ~a, ~um     adj.   = Vesuuius.
Ūriī	     ~ōrum     m. pl.   The name of some place associated with the cult of Venus, perhaps = Urium, a town on the Apulian coast near Mount Garganus.
xylocinnamum	     ~ī     neut.   = xylocinnamōmum.
Zanclēius	     ~a, ~um     adj.   = Zanclaeus.
acceptor2	  m.   = accipiter. exta ~oris et unguis   Lucil.   1170.
acertās	  f.   (perhaps) = ācritās.
*Acesta	  f.   A town of NW Sicily = Segesta1.
acorion	  neut.   = acoron b.
adagium	  neut.   = adagiō. uetus ~ium est: nihil cum fidibus graculost, nihil cum amaracino sui   Gel.   pr.19;   Apul.     Mun.   14; ~ia ad agendum apta   Paul.     Fest.   p.12M.
Adiabēnus	  adj.   = Adiabēnicus.   Tac.     Ann.   15.14.
Aecetia	  f.   (apparently for *  Aequitia   = aequitās) The goddess Equity.
aedituus	  m.   = aeditumus.
Aeētīnē	  f.   = Aeētias.
Aeētis	  f.   = Aeētias.
Aegīnētae	  m. pl.   = Aegīnensēs.
Aequīcolānī	  m. pl.   = Aequīculus.
#Aesculāpius1	  m.   (mythology) A son of Apollo and Coronis, celebrated for his medical skill (cf. Asclēpius);   insula ~i   = the   insula Tiberina   at Rome.
aesum	  neut.   = aizōum.
Agamemnonidēs	  m.   A son of Agamemnon (in quotation = Orestes).
Agyrīnus	  adj.   = Agyrīnensis.
Alabandēus	  adj.   = Alabandensis.   Cic.     Brut.   325;   Vitr.   3.2.6.
Alabandicus	  adj.   = Alabandēus.   Plin.     Nat.   21.16; 37.92.
Alcimeōn	  m.   = Alcmaeōn.
Alcumēna	  f.   = Alcmēna.
Alēus1	  adj.   = Alēius.
aliquis2	  adj.   = aliquī1 (in other cases identical).
alus	  f.   = alum.
Amathūsius	  adj.   = Amathūsiacus; (f. as noun) Venus.
Amazona	  f.   = Amazōn.
Amazonis	  f.   = Amazōn.
Aniēnis	  adj.   = Aniēnsis.
anthyllum	  neut.   = anthyllium (i).
aquēductus	  m.   = aquaeductus.
Arabus	  adj.   Arabian; (m. pl. as noun) the Arabs;   ~us lapis   = arabica.
argemōnē	  f.   = argemōnia.
aureae	  f. pl.   (see quotation, but probably = ōreae).
Ausoniī	  m. pl.   = Ausonidae.
Azabēnicus	  adj.   = Adiabēnicus.   CIL   13.8979.
scīn	   (=   scisne  ) see sciō, -ne.
