CicPhi08	Cicero,PhilippicaOratio_CicPhi08
CicArch	Cicero,ProArchia_CicArch
CicMil	Cicero,ProMilone_CicMil
CicRabP	Cicero,ProRabirioPostumo_CicRabP
CicPVati	Cicero,ProPVatinioFragmenta_CicPVati
Cic2Ver4	Cicero,InVerremActioSecunda_Cic2Ver4
CicRabPe	Cicero,ProCRabirioPerduellionisReo_CicRabPe
Cic2Ver5	Cicero,InVerremActioSecunda_Cic2Ver5
CicBalb	Cicero,ProBalbo_CicBalb
CicPhi09	Cicero,PhilippicaOratio_CicPhi09
CicTogCan	Cicero,InSenatuInTogaCandidaContraCAntoniumEtLCatilinamCompetitoresFragmenta_CicTogCan
Cic2Ver2	Cicero,InVerremActioSecunda_Cic2Ver2
Cic2Ver3	Cicero,InVerremActioSecunda_Cic2Ver3
CicLegA1	Cicero,DeLegeAgraria_CicLegA1
CicLegA3	Cicero,DeLegeAgraria_CicLegA3
Cic2Ver1	Cicero,InVerremActioSecunda_Cic2Ver1
CicLegA2	Cicero,DeLegeAgraria_CicLegA2
CicCFund	Cicero,ProCFundanioFragmenta_CicCFund
CicSul	Cicero,ProSulla_CicSul
CicHarus	Cicero,DeHaruspicumResponso_CicHarus
CicProv	Cicero,DeProvinciisConsularibus_CicProv
CicMetel	Cicero,ContraContionemQMetelliFragmenta_CicMetel
CicAClu	Cicero,ProACluentio_CicAClu
CicCat4	Cicero,InCatilinam_CicCat4
CicVatin	Cicero,InVatinium_CicVatin
CicCat1	Cicero,InCatilinam_CicCat1
CicSenec	Cicero,DeSenectute_CicSenec
CicLVare	Cicero,ProLVarenoFragmenta_CicLVare
CicMTull	Cicero,ProMTullio_CicMTull
CicCat3	Cicero,InCatilinam_CicCat3
CicDeiot	Cicero,ProRegeDeiotario_CicDeiot
CicCat2	Cicero,InCatilinam_CicCat2
CicAerAl	Cicero,InterrogatioDeAereAlienoMilonisFragmenta_CicAerAl
CicIncFr	Cicero,Incertarum0rationumFragmenta_CicIncFr
CicACaec	Cicero,ProACaecina_CicACaec
CicPis	Cicero,InLCalpurniumPisonem_CicPis
CicQuaest	Cicero,CumQuaestorLilybaeoDecederetFragmenta_CicQuaest
CicCael	Cicero,ProCaelio_CicCael
CicMFont	Cicero,ProMFonteio_CicMFont
CicMarc	Cicero,ProMarcello_CicMarc
CicSRosc	Cicero,ProSRoscioAmerino_CicSRosc
CicSest	Cicero,ProSestio_CicSest
CicFlac	Cicero,ProFlacco_CicFlac
CicLudCo	Cicero,CumALudisContionemAvocavitFragmenta_CicLudCo
CicClodi	Cicero,InPClodiumEtCCurionemFragmenta_CicClodi
CicRedS	Cicero,PostReditumInSenatu_CicRedS
CicCorn2	Cicero,ProCornelioFragmenta_CicCorn2
CicDivCa	Cicero,DivinatioinQCaecilium_CicDivCa
CicPhi01	Cicero,PhilippicaOratio_CicPhi01
CicOppio	Cicero,ProOppioFragmenta_CicOppio
CicLig	Cicero,PrLigario_CicLig
CicAmici	Cicero,DeAmicitia_CicAmici
CicNegAc	Cicero,ProNegotiatoribusAchaeisFragmenta_CicNegAc
CicRedQ	Cicero,PostReditumAdQuirites_CicRedQ
CicPhi14	Cicero,PhilippicaOratio_CicPhi14
CicCorn1	Cicero,ProCornelioFragmenta_CicCorn1
CicPhi02	Cicero,PhilippicaOratio_CicPhi02
CicDeImp	Cicero,DeImperioCnPompei_CicDeImp
Cic1Ver	Cicero,InVerremActioPrima_Cic1Ver
CicDomo	Cicero,DeDomoSua_CicDomo
CicPhi03	Cicero,PhilippicaOratio_CicPhi03
CicPhi13	Cicero,PhilippicaOratio_CicPhi13
CicAlex	Cicero,DeRegeAlexandrinoFragmenta_CicAlex
CicPhi07	Cicero,PhilippicaOratio_CicPhi07
CicOffic2	Cicero,DeOfficiis_CicOffic2
CicQGal	Cicero,ProQGallioFragmenta_CicQGal
CicMur	Cicero,ProMurena_CicMur
CicQRosc	Cicero,ProQRoscioComoedo_CicQRosc
CicOffic3	Cicero,DeOfficiis_CicOffic3
CicQuinc	Cicero,ProPQuinctio_CicQuinc
CicPhi06	Cicero,PhilippicaOratio_CicPhi06
CicPhi12	Cicero,PhilippicaOratio_CicPhi12
CicPhi04	Cicero,PhilippicaOratio_CicPhi04
CicPhi10	Cicero,PhilippicaOratio_CicPhi10
CicOffic1	Cicero,DeOfficiis_CicOffic1
CicPlanc	Cicero,ProPlancio_CicPlanc
CicMScau	Cicero,ProMScauroFragmenta_CicMScau
CicCMani	Cicero,ProCManilioFragmenta_CicCMani
CicPhi11	Cicero,PhilippicaOratio_CicPhi11
CicPhi05	Cicero,PhilippicaOratio_CicPhi05
PliEp06	Plinius,PliniusEpistulae_PliEp06
PliEp07	Plinius,PliniusEpistulae_PliEp07
PliEp05	Plinius,PliniusEpistulae_PliEp05
PliEp10	Plinius,PliniusEpistulae_PliEp10
PliEp04	Plinius,PliniusEpistulae_PliEp04
PliEp01	Plinius,PliniusEpistulae_PliEp01
PliEp03	Plinius,PliniusEpistulae_PliEp03
PliEp02	Plinius,PliniusEpistulae_PliEp02
PlinPane	Plinius,PliniusPanegyricus_PlinPane
PliEp09	Plinius,PliniusEpistulae_PliEp09
PliEp08	Plinius,PliniusEpistulae_PliEp08
VerGeor3	Vergilius,Georgica_VerGeor3
VerGeor2	Vergilius,Georgica_VerGeor2
VerGeor1	Vergilius,Georgica_VerGeor1
VerGeor4	Vergilius,Georgica_VerGeor4
VerAen09	Vergilius,Aeneis_VerAen09
VerAen08	Vergilius,Aeneis_VerAen08
VergEclo	Vergilius,Eclogae_VergEclo
VerAen01	Vergilius,Aeneis_VerAen01
VerAen03	Vergilius,Aeneis_VerAen03
VerAen02	Vergilius,Aeneis_VerAen02
VerAen06	Vergilius,Aeneis_VerAen06
VerAen12	Vergilius,Aeneis_VerAen12
VerAen07	Vergilius,Aeneis_VerAen07
VerAen11	Vergilius,Aeneis_VerAen11
VerAen05	Vergilius,Aeneis_VerAen05
VerAen04	Vergilius,Aeneis_VerAen04
VerAen10	Vergilius,Aeneis_VerAen10
SenTranq	Seneca,DeTranquillitateAnimi_SenTranq
SenHerOe	Seneca,HerculesOetaeus_SenHerOe
SenTroad	Seneca,Troades_SenTroad
SenOedip	Seneca,Oedipus_SenOedip
SenIra2	Seneca,DeIra_SenIra2
SenIra3	Seneca,DeIra_SenIra3
SenConst	Seneca,DeConstantia_SenConst
SenIra1	Seneca,DeIra_SenIra1
SenPhaed	Seneca,Phaedra_SenPhaed
SenBrevi	Seneca,DeBrevitateVitae_SenBrevi
SenEpist	Seneca,AdLuciliumEpistulaeMorales_SenEpist
SenOtio	Seneca,DeOtio_SenOtio
SenApoco	Seneca,Apocolocyntosis_SenApoco
SenHerFu	Seneca,HerculesFurens_SenHerFu
SenProvi	Seneca,DeProvidentia_SenProvi
SenPolyb	Seneca,AdPolybiumDeConsolatione_SenPolyb
SenMedea	Seneca,Medea_SenMedea
SenAgamn	Seneca,Agamemnon_SenAgamn
SenBenef	Seneca,DeBeneficiis_SenBenef
SenHelvi	Seneca,AdHelviamMatremDeConsolatione_SenHelvi
SenPhoen	Seneca,Phoenissae_SenPhoen
SenClem2	Seneca,DeClementia_SenClem2
SenVitBe	Seneca,DeVitaBeata_SenVitBe
SenMarci	Seneca,AdMarciamDeConsolatione_SenMarci
SenClem1	Seneca,DeClementia_SenClem1
SenThyes	Seneca,Thyestes_SenThyes
PetronSa	Petronius,PetroniusSatiricon_PetronSa
SalHistF	Sallustius,FragmentaHistoriarum_SalHistF
SalJugur	Sallustius,Jugurtha_SalJugur
SalCatil	Sallustius,Catilina_SalCatil
CaesBG1	Caesar,BellumGallicum_CaesBG1
CaesBG3	Caesar,BellumGallicum_CaesBG3
CaesBG2	Caesar,BellumGallicum_CaesBG2
CaesBG6	Caesar,BellumGallicum_CaesBG6
CaesBG7	Caesar,BellumGallicum_CaesBG7
CaesBG5	Caesar,BellumGallicum_CaesBG5
CaesBG4	Caesar,BellumGallicum_CaesBG4
CaesBC1	Caesar,BellumCivile_CaesBC1
CaesBC2	Caesar,BellumCivile_CaesBC2
CaesBC3	Caesar,BellumCivile_CaesBC3
HorSerm2	Horatius,HorSermones_HorSerm2
HorSerm1	Horatius,HorSermones_HorSerm1
HorArsPo	Horatius,ArsPoetica_HorArsPo
HorEpodi	Horatius,Epodi_HorEpodi
HorSaecu	Horatius,CarmenSaeculare_HorSaecu
HorCarm1	Horatius,Carmina_HorCarm1
HorEpis1	Horatius,HorEpistulae_HorEpis1
HorCarm2	Horatius,Carmina_HorCarm2
HorEpis2	Horatius,HorEpistulae_HorEpis2
HorCarm3	Horatius,Carmina_HorCarm3
HorCarm4	Horatius,Carmina_HorCarm4
PlCapt	Plautus,Captiui_PlCapt
PlAsina	Plautus,Asinaria_PlAsina
PlAulul	Plautus,Aulularia_PlAulul
PlEpidic	Plautus,Epidicus_PlEpidic
PlBacch	Plautus,Bacchides_PlBacch
PlCasin	Plautus,Casina_PlCasin
PlCurcu	Plautus,Curculio_PlCurcu
PlAmphi	Plautus,Amphitruo_PlAmphi
TacAnn01	Tacitus,TacAnnales_TacAnn01
TacAnn15	Tacitus,TacAnnales_TacAnn15
TacAnn14	Tacitus,TacAnnales_TacAnn14
TacAnn16	Tacitus,TacAnnales_TacAnn16
TacAnn02	Tacitus,TacAnnales_TacAnn02
TacAnn03	Tacitus,TacAnnales_TacAnn03
TacAnn13	Tacitus,TacAnnales_TacAnn13
TacAnn06	Tacitus,TacAnnales_TacAnn06
TacAnn12	Tacitus,TacAnnales_TacAnn12
TacAnn04	Tacitus,TacAnnales_TacAnn04
TacAgric	Tacitus,TacAgricola_TacAgric
TacAnn11	Tacitus,TacAnnales_TacAnn11
TacAnn05	Tacitus,TacAnnales_TacAnn05
TacGerma	Tacitus,TacGermania_TacGerma
TacHist1	Tacitus,TacHistoriae_TacHist1
TacHist3	Tacitus,TacHistoriae_TacHist3
TacHist2	Tacitus,TacHistoriae_TacHist2
TacDialo	Tacitus,TacDialogusDeOratoribus_TacDialo
TacHist5	Tacitus,TacHistoriae_TacHist5
TacHist4	Tacitus,TacHistoriae_TacHist4
CatAgr	Cato,CatoAgricultura_CatAgr
CatOrat	Cato,CatoOrationumFragmenta_CatOrat
CatOrig	Cato,CatoOrigines_CatOrig
CatFrag	Cato,CatoFragmentaReliqua_CatFrag
QCurt08	Curtius,CurtiusHistoriaeAlexandriMagni_QCurt08
QCurt09	Curtius,CurtiusHistoriaeAlexandriMagni_QCurt09
QCurt03	Curtius,CurtiusHistoriaeAlexandriMagni_QCurt03
QCurt10	Curtius,CurtiusHistoriaeAlexandriMagni_QCurt10
QCurt04	Curtius,CurtiusHistoriaeAlexandriMagni_QCurt04
QCurt05	Curtius,CurtiusHistoriaeAlexandriMagni_QCurt05
QCurt07	Curtius,CurtiusHistoriaeAlexandriMagni_QCurt07
QCurt06	Curtius,CurtiusHistoriaeAlexandriMagni_QCurt06
OviRemed	Ovidius,RemediaAmoris_OviRemed
OviEpist	Ovidius,HeroidumEpistulae_OviEpist
OviIbin	Ovidius,InIbin_OviIbin
OviAmor2	Ovidius,Amores_OviAmor2
OviAmor3	Ovidius,Amores_OviAmor3
OvFasti1	Ovidius,Fasti_OvFasti1
OvFasti3	Ovidius,Fasti_OvFasti3
OviAmor1	Ovidius,Amores_OviAmor1
OvFasti2	Ovidius,Fasti_OvFasti2
OvFasti6	Ovidius,Fasti_OvFasti6
OviArsA1	Ovidius,ArsAmatoria_OviArsA1
OviArsA3	Ovidius,ArsAmatoria_OviArsA3
OvFasti5	Ovidius,Fasti_OvFasti5
OvFasti4	Ovidius,Fasti_OvFasti4
OviArsA2	Ovidius,ArsAmatoria_OviArsA2
OviHalie	Ovidius,Halieutica_OviHalie
OviMedic	Ovidius,MedicaminaFacieiFemineae_OviMedic
PersiusS	Persius,PersiusSatirae_PersiusS
LucrDRN4	Lucretius,DeRerumNatura_LucrDRN4
LucrDRN5	Lucretius,DeRerumNatura_LucrDRN5
LucrDRN6	Lucretius,DeRerumNatura_LucrDRN6
LucrDRN2	Lucretius,DeRerumNatura_LucrDRN2
LucrDRN3	Lucretius,DeRerumNatura_LucrDRN3
LucrDRN1	Lucretius,DeRerumNatura_LucrDRN1
TibEleg1	Tibullus,TibElegiae_TibEleg1
TibEleg2	Tibullus,TibElegiae_TibEleg2
TibEleg3	Tibullus,TibElegiae_TibEleg3
Propert4	Propertius,PropertiusElegiae_Propert4
Propert1	Propertius,PropertiusElegiae_Propert1
Propert3	Propertius,PropertiusElegiae_Propert3
Propert2	Propertius,PropertiusElegiae_Propert2
HirtBG8	Hirtius,Bellum8Gallicum_HirtBG8
BAlex	PseudoCaesar2,BellumAlexandrinum_BAlex
BAfr	PseudoCaesar1,BellumAfricanum_BAfr
BHisp	PseudoCaesar3,BellumHispanum_BHisp
JuvSatur	Juvenalis,JuvSaturae_JuvSatur
Catul	Catullus,Catullus_Catul
